Агәымшәа 	﻿Храброе сердце 
Шаҭландиа 1280 шықәса 	Шотландия 1280 год 
Сара ишәасҳәоит Уилиам Уалас дазусҭоу. 	Я поведаю вам историю Уильяма Уоллеса. 
Англиатәи аҭоурыхҭҵааҩцәа исышьҭоуп амцҳәаҩ ҳәа, 	Английские историки назовут меня лжецом, 
аха аҭоурыхҭҵааҩцәа ирыҩҩоит, дарбану икнарҳауа афырхаҵа. 	но истории пишут те, кто сдергивал героев. 
Шаҭландиатәи акрал дыԥсоит ихылҵыз ҳәа уаҩ даанмыжькәа. 	Король Шотландии умер, не оставив сына после се 
аха Англиа акрал, ишьҭоуп иџьбароу аԥсабара амҵахырхәаҩ Едуард ашьап ҩзы ҳәа, 	И король Англии, жестокий язычник по прозвищу Эдвард Длинноногий, 
хьӡыс изыхҵоу ирылеиҳәеит иара дышнеиуа Шаҭландиатәи апресҭол ахь. 	заявил свои притязания на трон Шотландии. 
Шаҭландиатәи аристократцәа иҿагыланы 	Шотландская знать сражалась с ним и победила 
еимаркәан дара-дарала агәыргьын. 	и сражалась между собой за корону. 
Абар Едуард даарыԥхьоит аинааларазы, 	Тогда Длинноногий пригласил их на переговоры о мире. 
абџьарда. 	Без оружия. Только по одному оруженосцу. 
Адгьыл иқәаарыхәа рыбжьара дыҟан Малкым Уалас, 	Одним из фермеров того графства был Малколм Уоллес, 
уи аҟара зыхьыӡнагамыз иакәын. 	простой землевладелец. 
Иара иман ҩыџьа арԥарцәа, Џьони Уилиами. 	У него было двое сыновей: Джон и Уильям. 
Иуасымҳәази аҩны уҟаз ҳәа. 	Я же сказал тебе остаться. 
Сара аусқәа зегь ҟасҵеит. Шәабацои шәара? 	Ну, я уже все закончил. Куда мы едем? 
Макьандруз иахь. Ааԥхьара ҳаиҭеит аицәажәара аамышьҭахь. 	К МакАндрюсу. Он собирался зайти после жатвы. 
- Сара сцар ҟалома? - Мап, уца аҩныҟа. 	- Я могу поехать? - Нет, ступай домой, малыш. 
- суҳәоит. - Уца аҩныҟа, исҳәа умаҳаӡои? - Уца Уилиам. 	- Но я хочу туда. - Ступай домой или я тебе всыплю. 
Макьандруз! Макьандруз! 	МакАндрюс! 
О анцәа 	Боже мой. 
О анцәа Уилиам. 	Уильям. 
зегь бзиоуп, зегь бзиоуп, зегь бзиоуп, уҽаанкыл. 	Все в порядке, все в порядке. Спокойней, парень. 
Уилиам. 	Уильям. 
ҳара ҳарҽагылароуп, ҳреислароуп. Дара ҳара ҳақәырхоит. 	Я считаю нужно сразу же их атаковать. 
- ҳара ҳрызиааиӡом. - Аҭак раҳҭароуп. 	- Но мы не можем сражаться с ними. - Что-то нужно сделать. 
Пол диашоуп. ҳшьа ҳуроуп. 	Уоллес прав. Атакуем их. 
Дара зегьы ирҽагылаз икнаҳауп асураҿы. 	Но все дворяне, кто желал сражаться, были на том собрании. 
ҳара ҳрызиааиӡом. 	Мы не можем победить армию. 
Ҩынҩижәа жәабаҩык арахәааӡаҩцәа. 	Не с той полсотни фермеров, которых мы поднимем. 
- ҳара ҳрабашьлароуп. - Дара иааиуеит. 	Не нужно побеждать. Просто сражайтесь с ними. 
- Сара сахь ицода? - Сара, саргьы, саргьы, саргьы. 	- Кто со мной? - Я, Уоллес. 
- Ибзиоуп, ибзиоуп. - абасоуп. 	Ладно, ладно. 
- Уабадәықәла? - уара уахьцо сцоит. 	- Куда это ты собрался? - Я поеду с вами. 
сара сахьцо уцуану? Нас иҟауҵози уа? 	Да ну? И что ты будешь делать? 
- Сыцхырауеит. - еилкаауп уара уцхыраҩ бзиоуп. 	- Я помогу вам. - Ты то поможешь. 
Сара исҭахуп аҩны сахынӡаҟам, 	Но мне нужно, чтобы ты остался здесь 
Сыҩны уахылаԥшып ҳәа. 	и присматривал за хозяйством, пока меня не будет. 
Аисшьа здыруеит. 	Я могу сражаться. 
Издыруеит, уара уи ишулшуа 	Я знаю. Знаю, что ты можешь сражаться. 
Аха ҳҟәышзароуп ҳара ауаҩра Ианҳалҵуа. 	Но лишь разум делает нас мужчинами. 
Уаҵәынӡа. 	Увидимся завтра. 
- уҽыҵәах. 	- Англичане. - Пригнись. 
Уашьеи уаби рыда дара ҳаршьоит, Арахәааӡарҭа рыблоит. 	Пока нет твоего отца и брата они убьют нас и сожгут ферму. 
Ари зегьы аилазаара ҳуалуп. Абри ауп уара, иҳ уара. 	Все в наших руках, Хэмиш. 
Саб,саб. 	Пап? 
Уилиам! 	Уильям. 
Ара уааи. 	Иди сюда, парень. 
Уилиам. 	Уильям. 
Сара уаб иашьа Аргаил соуп. 	Я твой дядя Аргайл. 
Уара уан улеиԥшуп. 	Ты похож на свою мать. 
Уаха ара ҳаангылан, уаҵәы сара сахь ҳцап. 	Мы сегодня побудем здесь, а завтра ты поедешь со мной. 
Сара исҭахӡам ақәҵра. 	Я не хочу уезжать. 
Уара иуҭахызма уаб дыԥсыр, 	Ты не хотел, чтобы твой отец погиб, правда? 
аха иара дҭахеит, 	Но так случилось. 
Аԥап аԥсы диԥшьеит, 	Слышал, что говорил священник? 
анцәа духәааит, 	Господь благословит тебя и наставит... 
Иара лаҭын бызшәоуп. 	Но это же на латыни было. 
Уара иузымдырӡои Алаҭынбызшәа? 	Ты не говоришь на латыни? 
Ҳара уи ҳариашароуп, ус акәӡами? 	Придется нам это исправить. 
Анцәа духәааит, 	Господь, 
уеиқәирхааит,духылыԥшаит, 	да благословит тебя и спасет. 
илашоу ахыҿра 	Господь, да прольет свой свет на тебя. 
Уиҭалаит, 	И да поможет тебе Господь 
Аҭынчра, 	и упокоит душу твою. 
Амин. 	Аминь. 
Угәы аԥсы ашьап, 	Твое сердце свободно. 
Умшәан. Дара рышҭалараан. 	Найди мужество следовать за ним. 
Иҟарҵо закузеи? 	Что они делают? 
Абзиараз ҳәа еибырҳәоит дара ртәала. 	Прощаются с ним по-своему. 
Ихәмаруеит иҟамло авалынкақәа рыла аволынка. 	Играют запрещенные мелодии на запрещенных волынках. 
Ҳаб даныршьуаз убри аҩыза ахҭыс ҳхаҳгеит уабгьы саргьы. 	Тоже самое было со мной и твоим папой, когда убили нашего отца. 
Аханатә иуҵароуп ахархәашьа, 	Сначала научись пользоваться... 
абри ала 	этим. 
нас сара иусырҵоит ахархәашьа 	А затем я научу тебя использовать... 
абри ала. 	это. 
Лондон 	Лондон 
Акрынҵы ашьтахь 	Много лет спустя, 
Едуард ашьапҩзы Англиа акрал 	Эдуард Длинноногий, король Англии, 
еиҿикааит иҷкәын ичара итрон дықәланы дцарц азы, 	наблюдал за венчанием старшего сына, который был наследником трона. 
амин. 	Аминь. 
Ҭацас иҷкәын изы иара далыхит 	Невестой для сына 
иара иандаҭлоз иԥҳа. 	Длинноногий выбрал дочь своего врага, 
Франциа акрал. 	короля Франции. 
Зехьынџьара иалацәажәон аҭаца хшаара дшылмоуа Едуард ашьаԥыҩзы ицхыраарада. 	Повсюду ходили слухи, что Длинноногий лично приложил усилия, 
Убри иара иӡбхьан аханатәгьы. 	чтобы принцесса зачала.
Шаҭландиа … 	Шотландия... 
сара сыдгьыл. 	моя земля. 
Франциа иԥсыҽхоит амчра змоу рҽаԥхьа 	Французы будут ползать на брюхе перед силой и мощью, 
Нас дара агәра зларгоит ҳара ҳамчра иаҳзеиҽымкааозар ҳадгьыл бжьахаҟны! 	но как они уверуют в нашу силу, если мы не можем править на всем острове? 
- Дабоҟоу сыҷкәын? - Саҭамзааит шәыҳарагыра. 	- Где мой сын? - Простите, мой господин. 
Иара дсыҳәеит ихаҭарнакс сҟаларц. 	Он меня попросил придти вместо него. 
Сара сзыԥхьаз иара иоуп, бара бокуӡом. 	Я послал за ним, а он посылает тебя. 
Сара сцома шәхаҵкы? 	Мне уйти, мой господин? 
Сыҷкәын иҭахызар бара быҟалара аҳәынҭқарра аныҟәгара, сара сынԥслак ашьҭахь, 	Если он хочет, чтобы его королева правила, когда меня не станет, 
Нас баанха, егьи иҵала сбыҳәоит. 	тогда оставайся и учись, будь добра. 
Аамсҭцәа. 	Дворяне. 
Аамсҭцәа – ацаԥха Шаҭладиа агәашәахь. 	Дворяне - ключ к двери Шотландии. 
Ирышәҭ ҳаамсҭцәа ашхаратәи адгьылқәа 	Дать нашим дворянам землю в Шотландии. 
Насгьы дара раамсҭцәа ирышәҭа абра Англиа аҟны. 	Дать их знати поместья здесь, в Англии. 
Раҳарамра, иднарҟаҵом ҳара ҳҿагылара. 	И они из-за жадности не смогут противостоять нам. 
Шәхаҵкы,ҳара ҳамсҭцәа иқәҵны ацара рҭаххаӡом. 	Но, сэр, наши дворяне не охотно будут переселяться. 
Адгьыл ҿыцқәа, аналог ҿыцқәа. 	Новые земли - значит новые налоги, 
Дара иршәахьеит, Франциа аибашьразы 	а мы уже взимали дань на войну с Францией. 
Абасоуп, 	Правда? 
ишыҟоу, унан! 	Правда? 
Сара стәала Шотландиа 	Проблема в Шотландии - 
иҟәоуп ирацәаны Шотландцәа. 	то, что там полно шотландцев. 
Сгәаныла иааит аамҭа еиҭарҿыцтәзар ажәытә қьабзқәа, 	Возможно, пришло время восстановить старый обычай. 
ирышәҭа Прима-нокҭа. 	Дать им "приме нокти". 
Актәи ауха азин. 	В первую ночь. 
Дарбанзаалак аҭыԥҳа, актәи ауха аан, 	Когда любая простая девушка, живущая там, будет выходить замуж, 
аамсҭа имоуп азин лара лцәа ԥиҽыр. 	наш дворянин будет иметь сексуальное право на невесту в брачную ночь. 
Дара ҳаздәылымцозар зынӡа, 	Если мы не можем их выселить, 
иқәхтәуп мҭашьҭала. 	мы выживем их таким образом. 
Шотландиа иаҳнардырует ҳара иаҳнаало 	Это понравится тем дворянам, которым мы дадим землю в Шотландии. 
аналог ашәара аку, мамзар амшәара аку. 	С налогами или без налогов. 
Даара бзианы ишәҳәеит шәхаҵкы. 	Превосходная идея, сэр. 
Иҵабыргну? 	Разве? 
Еденбра 	Эдинбург 
Еденбра еизеит абыргцәа рхеилак. 	В Эдинбурге мы собрали совет шотландской знати. 
Урҭ рыбжьара дыҟан Роберт, жәибыжьтәи ахылҵшьҭра аграф Брусаа. 	Среди них был Роберт, семнадцатый граф Брюс, 
Ихадоу апритиндент Шотландиатәи агәыргьын азы. 	основной претендент на корону Шотландии. 
Сара исаҳаит ашьапҩзы азин ииҭеит Прима-нокта. 	Я слышал, что Длинноногий пожаловал право "прима нокти". 
Иааигар иҭахуп иара идгылаҩцәа. 	Он явно хочет привлечь сюда больше своих сторонников. 
Саб иԥхьаӡоит ҳагәра игарц ашьапҩзы. 	Мой отец считает, что мы должны войти в доверие Длинноногому. 
Шәадымгылан иара идекрет, насгьы шәаҿамгылан иара. 	Не поддерживать его декрет, и не противостоять ему. 
Иҟушу плануп. 	Мудрый план. 
Уаб дышԥаҟоу? Иара аилабжьараҿы дазхом. 	Как твой отец? Он не пришел на совет. 
Аусқәа дныркылоит Франциа. 	Он запоздал из-за дел во Франции. 
Аха, иара иааишьҭит асалам, 	Но он отправил приветствия. 
Иҳәеит срацәажәеит Брусиаа зегьы рыхьӡала, 	И сказал, что я буду говорить от имени всех Брюсов 
Насгьы Шотландиа азы. 	и Шотландии. 
- иааԥцәаны абасоуп. - Уԥши, уԥши! - уара иуцәкаҳаит ухаҳә. - Ахаҵа игәаҭара. 	- Ты уронил камень. - Проверка мужества. 
Уара уаиааит. 	Ты победил. 
Иазаҳҳәап арратә гәаҭара. 	Так назови это проверкой доблести. 
Англызцәа абџьар ҳамазар руӡом. 	Англичане не позволяют нам упражняться с оружием, 
Убри азыҳәан ҳара ҳҽазыҟаҳҵоит хаҳәла. 	так мы упражняемся с камнями. 
Аруаҩ иаашьа имч инапы иакӡам. Араауп. 	Сила солдата не в руках. Она здесь. 
Мамоу, абар иахьыҟоу. 	Нет, она здесь. 
Ҳеимиш? 	Хэрниш? 
Аҳы … иааг сыҷқәын, иааг. 	Давай, сынок, покажи ему. 
- Ҳеимиш. - иааг сыҷқәын, иааг. 	- Давай, Хэрниш. - Вперед, мальчик. 
- Ҳеимиш иааг иааг Ҳеимиш,Ҳеимиш. - Афеирым. 	Давай! 
Даара ибзианы иуршәт. 	Хороший бросок. 
Аҳаҳ, иҵегьы шәара. 	Это уж точно. 
Ианба хадарахо уара аус иузыҟаҵо? 	Интересно, сможешь ли ты его повторить, когда будет нужно. 
Иаҳхәап ианцо аибашьра. 	Скажем в бою. 
Уара уизиааиру ауаҩы? 	Ты можешь сокрушить человека таким броском? 
Сара усырҟьцоит ахәац еиԥш. 	Я могу раздавить тебя, как червяка. 
- Иашану? - Ааи. 	- Правда? - Да. 
Нас уааи, ишәҭахума ижәбар, сара сыширҟьцо? 	Ну так сделай это. Хотите это увидеть? 
- Уааи. - уара уахьхәоит 	- Давай, сделай это. - Ты пригнешься. 
- Мамоу сахьхәӡом. - Е-е-е Уара ус угәы иаанагоит. 	- Нет. - Хорошо. 
- Иара дгьыжьӡом. - Иара уажә дыҩоит 	Он пригнется. 
Уаа сыҷқәын. 	Давай, Хэрниш. 
Уаа сыҷқәын. 	Давай, мальчик. 
Даара ибзианы иуршәт Уалас. 	Отлично. 
- Ушԥаҟоу? Узазоит. - исхамшҭи ахаҳәқәа ртәы. Уи иашаҵәҟьоуп. 	- Неплохое представление. - Все в порядке? 
- Уара уԥштәы ҽеим. - Сара иансгәалашәа ахаҳәқәа. 	- Ты что-то слабо выглядишь. - Мне стоило помнить про камни. 
Ааи. 	Да уж. 
Угыл сҩыза. 	Вставай, ты, куча. 
- сгәы иаахәоит убара. - уахцо уаалеит. 	- Рад снова видеть тебя. - Добро пожаловать домой. 
- Уахәаԥш ухы иазууз. - уааҳәыр акун. 	- Смотри что ты сделал с головой. - Тебе стоило пригнуться. 
Уилиам, усыцкәашома? 	Уильям, потанцуешь со мной? 
Ааи, сбыцкәашоит. 	Конечно. 
Сара сааит ишәыласҳәарц актәи ауха азинқәа. 	Я пришел заявить право "прима нокти". 
Сара изласхатәу ала абри адгьыл, исыԥшьоит 	Как повелитель этих земель я благословлю сей брак, 
Данызгалак аҭаца сара сиарахь, 	приняв невесту в своей кровати 
лара актәи ауха аҭаҳцәа еилазараан. 	в первую ночь их союза. 
Уаанӡа узнеирым. 	Клянусь Богом, не примешь! 
Уи сара исусуп. 	Такова моя дворянская привилегия. 
- Хәлыбзиақәа шәхаҵкы! - Ааи, Уилиам Уалас. 	- Добрый вечер, сэр. - Молодой Уоллес. 
- Ацх бзиами? - Ааи, усоуп. 	- Прекрасный мягкий вечер. - Да, уж точно. 
Иҟалома слацәажәар шәыӡӷаб? 	Могу я поговорить с вашей дочерью? 
Илоухәарц иуҭахузеи? 	О чем ты хочешь с ней поговорить? 
Исҳәар исҭаху … 	Ну... 
Марон, ԥсыцҽыжәлома игәзырҳагоу ауха? 	Маррон, хочешь покататься со мной сегодня? 
Ақәа шлеиоу? ухы еивҟьама? 	В такую погоду? Ты с ума сошел? 
Шотландиатәи ибзиаӡоу амш, 	Прекрасная шотландская погода, мадам. 
маҷк ақәа леиуеит. 	Дождь падает почти отвесный, его можно не заметить. 
- Лара дуццаӡом. - мап? 	- Она не поедет с тобой. - Нет? 
мап. А иахьа акәхаӡом. 	Нет. Уж точно не сейчас. 
- иахьа акәхаӡом? - иахьа акәхаӡом. 	- Не сейчас. - Не сейчас. 
Даҽазны. 	Увидимся. 
Амш бзиоуп, ақәа аарла илеиуеит. 	А вообще погода ничего. Едва моросит. 
Бара ибаҳама исҳәаз Марон? 	Ты не слышала, что я сказала? 
Марон, Марон бара … 	Маррон. 
Уӡӷаб зынӡа уара дуеиԥшуп. 	Это она в тебя такая взбалмошная. 
- сызлабдыри арасҟатәи аамҭа шцахьоугьы? - Сара усзымдарӡит. - Мап? 	- Как ты узнала меня после разлуки? - Не узнала. 
Усыхәаԥшуеит ула ааихмырсыӷьӡакәа, сара уара уӡусҭоу сзымдырӡит. 	Я увидела как ты смотрел на меня, и я не знала кто ты такой. 
Саҭамзааит,иашаны сбыхәаԥшуан сыла ааихмырсыӷьӡакәа. 	Прости, я думал, ты знала. 
Сгәаныла бара ибгәаԥхоит ибзымдыруа ауаҩы иҽықәтәара. 	И часто ты вот так ездишь под дождем, с незнакомцами? 
Ус уара укацара еиҳа имариан. 	Это был лучший способ сопроводить тебя. 
Даҽазны сара исыӡбыр убас аҟаҵара 	Если я наберусь смелости попросить тебя еще раз, 
сара бгәԥҽанысҵоит асалам шәҟәы ала. 	я тебя сначала предупрежу запиской. 
- Сара аԥхьашьа сыздырӡом, убри азыҳәан иаҭахым. - Бара алаф бҳәоит. 	- Не поможет. Я не умею читать. - Не умеешь? 
Мамоу. 	Нет. 
- нас иҳариашароуп, усами? - Аԥхьара сурҵар уҭахума? 	- Тогда нам придется это исправить. - Ты научишь меня читать? 
- Бара ибҭахызар. - Ааи. 	- Если захочешь. - Хорошо. 
- иарбан бызшәоу? - уара уҽхоит. 	- На каком языке? - Ты хвастун. 
- Ааи, бара бсыршанхама? - Мамоу, уҽазукәозма? 	- Правильно. Ты восхищена? - Нет. А должна? 
Ухы укәгыланы ари иузеиҭаҳәару? 	Повтори стоя на голове, и я буду впечатлена. 
Скилт схы иалазгалаԥ ҳәа, аха сҽазыскоит. 	Мой килт задерется, но я попробую. 
Уныҟәарақәа раан иудмарҵаӡеи аҟазшьа бзиа? 	Ты что, не научился вести себя в путешествиях? 
Афранцузцәеи Аримланцәеи рҿы ари аҟазшьа еиҳагьы еицәоуп. 	Французы и римляне еще хуже меня. 
Рим уара уцахьоума? 	Ты был в Риме? 
Ааи, саб иашьа сигахьеит анцәа имҵаныҳәарахь. 	Да, мы с дядей совершали паломничество. 
Изеиԥшрои иара? 	И какой он? 
Иара еиԥшӡам бара быԥшӡара. 	Он не сравнится с твоей красотой. 
Еиҭага. 	Что это значит? 
Рим ԥшӡоуп, 	Он прекрасен. 
аха ара са сыҩноуп. 	Но моя земля здесь. 
Марон, аҩныҟа бааи. 	Маррон. А ну, домой. 
Шәхаҵкы,сара издыуеит иҟасҵаз хәҷык акалашәақәа ишыҟоу, 	Сэр, я знаю, что с моей стороны было странным 
Марон ааԥхьара ианҳалҭа ҳнаиааирц, 	пригласить Марон прошлым вечером, но... 
ҳара даҽа уск аҵыхәала. 	Я не о дочери МакКланоха. 
- Уца аиԥыларахь. - Закәтә еиԥылареи? 	- Я пришел назначить тебе встречу. - Какую встречу? 
Имаӡоуп. 	Тайную. 
Уара уеиԥылара аамҭа арӡроуп Кьиамбыл. 	Эти встречи - пустая трата времени. 
Уаб деибашьҩын, 	Твой отец был воином 
иԥсадгьыл бзиа ибон. 	и патриотом. 
Сара издыруеит дазусҭоу. 	Я знаю кем был мой отец. 
Сара сгәы иҭоуп аҽаҩра аарыхра нас аҭаҳцәа аԥҵара. 	Я пришел домой возделывать землю, и даст Бог, завести семью. 
Ҭызшәада сынхалар сҭахуп. 	Если я могу жить в мире, я так и сделаю. 
Ҳцап. 	Поехали. 
Арахумра уҽацәыухьчома? 	Хочешь не вмешиваться в неприятности? 
Ааи. 	Да. 
Сыԥҳа улҿцаар ҟалоит, уара иузырҵабыргозар, 	Если докажешь это, можешь сватать мою дочь. 
макьаназ мап. 	Но пока не докажешь, ответ будет нет. 
- Мамоу. - Мамоу Уалас,мамоу. 	- Нет. - Нет, Уоллес, нет. 
- Уи исмырҵабыргӡаци? - Мап. 	- Разве я не доказал это? - Нет. 
- Мап? - Мап! 	- Нет? - Нет! 
ҳәарада, Арахәааӡарҭа иаҭахуп аусқәа рацәаны, 	Конечно, вести хозяйство нелегко, 
аха зегьы рҿырԥсахоит сыҷкәынцәа анаалак. 	но все изменится, когда появятся мои сыновья. 
Уара ахәыҷқәа иумоума? 	Так у тебя есть дети? 
Макьана мамоу,сгәы иаанагоит бара бсыцхраауеит. 	Еще нет, но я надеялся, ты мне с этим поможешь. 
Нас уара ԥҳәысыс сугар уҭахума? 	Ты хочешь, чтобы я вышла за тебя? 
Зегь сгәасҿанӡамкәуа ус иҟалеит. 	Это внезапное предложение, но я согласен. 
Ус анакәха ааԥхьара ҟауҵама? 	Так вот как ты делаешь предложения. 
Бзиа бызбоит сара. Енагь бысҭахын. 	Я люблю тебя. И всегда любил. 
Исҭахуп ԥхәысыс бызгар. 	Я хочу жениться на тебе. 
Ааи бхәама? 	Это значит да? 
- Ааи. - Ари ааи ауп. 	- Это значит да. - Неужели? 
- ҳаццакыроуп. Иара дҳазԥшыр ҟалоит. 	- Нам надо спешить. Он будет ждать. - Постой. 
Баангыл бабацои? 	Куда ты? 
- Ари закәи? - Уара иудырп. 	- Что это? - Увидишь. 
Аб аԥсыцқьа. 	Отец. 
Сара енагь бзиа бызбалоит, сыԥсҭазаара зегьы. 	Я буду любить тебя всю жизнь. 
Сара бара. 	Тебя и никого больше. 
Саргьы уара. 	А я тебя. 
Уараӡәк. Наӡаӡа. 	Тебя и никого другого. Всегда. 
Ҳамала ҳанбеикәшәо? Ахәылбыҿха? 	Когда я увижу тебя снова? Сегодня? 
- Сгәы иаанагом. - Избан? 	- Я не смогу. - Почему? 
Саб хәыҷык агура изгом. 	Мой отец что-то заподозрил. 
Нас агәра изымгалааит, иҭахызар. 	Странно. С чего бы это он? 
Ианба? 	Когда? 
Ианба? 	Когда? 
- Иҳәа ахәылыбыҽха. - Ахәылбыҽха? - Ааи. 	- Сегодня. - Сегодня? 
Шәааӡыҩри, аруаҩ. 	А вон та живенькая, сержант. 
Иаабго закәузеи? 	Что ты несешь, девчушка? 
- Ихьынҭуп, иааг сбыцхраап. - Мап. 	- Кажется тяжелая. Помочь? - Не стоит. 
Ибыхьи? Зегь бзиоуп. 	Я не собираюсь красть ее. 
Бара сыԥҳа блеиԥшнысшьалоит. 	Ты напоминаешь мне мою дочь. 
Мшабзиа аҭыԥҳа! 	Привет, девчушка. 
ԥшьала Смаит. 	Тише, Смайт. 
Агәмха! 	Стерва! 
Агәмха! 	Стерва! 
Зегь бзиоуп, зегь бзиоуп, баала. 	Ты в порядке? 
- Зегь бзиоуп. - Ибзиоуп. 	- Ты цела? - Да. 
- Бзақәтәома аҽы? - Ааи. 	- Ты можешь ехать? - Да. 
Уаангыл ацәыршәага. 	А ну вернись, ублюдок! 
Адырра ҟашәҵа, шәсыцхраа. 	Бейте тревогу! 
Бсызԥшыз бара асакараҿы. Уца. 	Встретимся в роще. 
Дара ҳарцәцоит. 	Они уходят. 
Дышәкы. Баҿашәит. 	Ну ладно, стерва! 
Марон! Марон! 	Маррон. 
Шәара зегь бзианы ижәдыруеит енагь. 	Всем вам прекрасно известно какие страдания я смиренно принимал. 
сара сазыҟаҵан сгәмбылџьбарамкәа ҳаԥҟарақәа рынагӡара. 	Я не был слишком строг, слишком суров и уважал ваши законы. 
Иара ус алҵшәақәа. 	И вот, в результате, 
Шәҟамлаӡеи шәара анхара 	разве мы не научились жить вместе 
Ҭынчны гармониала? 	в сравнительном мире и гармонии? 
А убас иахьатәи шәыԥҟара азакәандарала 	А сегодняшнее беззаконие... 
Шәара шәаҵоуп аҳақ,сара сычҳаразы. 	Вот как вы отплатили за мою снисходительность. 
Шәара исышәымҭеит алхра. 	Вы не оставили мне выбора. 
Ажәылара асалдат акрал уаҩ иахь 	Нападение на королевских солдат 
Иаанагоит ажәылара иара акрал иахь. 	это тоже самое, что и нападение на самого короля. 
Уажәшьҭа, 	Теперь, 
Ари аҽырҩашьа даиааиуеит сара сахь. 	пусть этот зачинщик выйдет ко мне. 
Абаар … 	Вон. 
Капрал … ахыци ахәымԥалыи ала ухыс абааш ахь, ирласны. 	Капрал, лучников на башню, живо! 
Уҽырӷәӷәуа, саб! 	Держитесь, отец! 
Усҟәаҵ. 	Идиот! 
- Саб, Ушԥаҟоу? - А-а-аҳ. 	- Отец, вы в порядке? - Да. 
Уалас-иԥа, Уалас-иԥа 	МакКолих. 
Уалас … Уалас … Уалас … Уалас! 	Уоллес! 
Узԥшузеи арԥыс? 	Чего ты ждешь, парень? 
Усҭ иҟаҵа ари, сара искызааит. 	Вот. Сделай это. Я подержу его. 
Усҭ ари ҟаҵа, сара искызааит. 	Вот. Сделай это. Я подержу его. 
Илышьҭы ишиашоу ахәра ашҟа. 	Лей прямо на рану, парень. 
Сара издыруеит ирыцҳаушьоит ависки. 	Я знаю, что это кажется впустую переводить хорошие виски. 
Сырҳәаза. 	Держи его, держи! 
Дышәкы, Дышәкы, Дышәкы, 	Отпускайте. 
Уажәшьҭа даушәышьҭ. 	Нормально? 
Ибзиаӡоу амч ҭаҵага. 	Тебя это утром разбудит, парень. 
- Аӡә ааскьара даҽуп арахь. - Абџьар ахь…… Шәласы, шәалга….. 	- Кто-то идет. - К оружию. 
Аӡә ааскьара даҽуп. 	Кто-то идет. 
Ари агәларатәи ақыҭантәи Магрегор. 	МакГрегорс. Из соседней долины. 
Ҳа ҳҟны зегьы ирдыруеит. Иҟалеи шәыззхьаауеи. 	Мы слышали о том, что произошло. 
Ҳара ҳада иаҳҭахӡам шәара шәлахҽыхра. 	Мы не хотим, чтобы вы считали, что можете развлекаться без нас. 
Аҩныҟа шәца. 	Идите домой. 
Шьҭахьҟа мҩа ҳамаӡам. 	Да, кое-кто из нас был в этом. 
Шәара макьана ишәымоуп. 	Я ничего не могу поделать, лишь вы сами можете себе помочь. 
Сшәыҳәоит шәазхәыц, аҩныҟа шәца. 	Идите домой. 
Ҳара иҳауӡом аҩнқәа 	У нас не останется домов, 
Англиантәи агарнизон абааш аҟнытә дааны ҳаҩнқәа абылра далагар. 	когда гарнизон англичан придет и сожжет их. 
Иашоуп. 	А они так и сделают. 
Бзиала шәаабеит! 	Добро пожаловать. 
Апатруль дхынҳәоит шәхаҵкы. 	Патруль возвращается, мой господин. 
Ажәабжь ҽыцқәа иҟои? 	Какие новости? 
Сара исшьҭит шәҩык ар Ланаркҟа. Дара хынҳәоит уажәыҵәҟа. 	Я отправил сотню солдат в Ланарк. Они сейчас вернутся. 
Дара абас аума ишеилаҳәаз? 	Они были одеты в это? 
Дара 50-ҩык ыҟан. 	Вообще-то их было не больше 50. 
Иаарласны. 	Побыстрее. 
Сугәалашәо? 	Помнишь меня? 
Сара лгәы нсырхаӡомызт, уи сара исусын. 	Я же ничего плохого не сделал. У меня было право. 
Уара иуусын! Сара сааит иуасҳәарц ахаҵа изинқәа. 	Твое право. А я пришел, чтобы заявить о праве мужа. 
Сара – Уилиам Уалас соуп. 	Я - Уильям Уоллес. 
Ҳара шәара шәаҳшьҭӡом. 	Мы пощадим остальных. 
Шәхынҳәы Англиаҟа. 	Возвращайтесь в Англию. 
Ирашәҳәа зегьы Шоҭландиа рыԥҳацәеи рыҷкәынцәеи зегьы рхы иақәиҭоуп ҳәа. 	И передайте, что дочери и сыновья Шотландии больше не ваши рабы. 
Шоҭландиа уажәшьҭа шәара ишәтәӡам. 	Скажите, что Шотландия свободна. 
Ишәыблы. 	Сжечь. 
Шотландиатәи ақәылаҩцәа ирыцҟьеит сгарнизонқәа руак, 	Шотландские повстанцы разгромили один из моих гарнизонов 
Дагьыршьоит дара аамсҭа. 	и убили благородного лорда. 
Сара исаҳаит. Убри Уалас дқәылаҩуп. 	Я слышал. Этот Уоллес всего лишь бандит. 
Ушԥаизныҟәоз уара абри ақәылаҩ? 	И как бы ты справился с этим бандитом? 
Иаабац ӷьычҩык еиԥш дысԥхьаӡоит. 	Как и с любым преступником. 
Аҭыԥантәи магистрат дҳәынҷаны ашьауӷа дақәыршәатәуп. 	Приказал бы судье арестовать и наказать его. 
Шәаҳҟәуаҵ. 	Оставьте нас. 
Уалас амагистрат дышьны ақалақь ааникылт. 	Уоллес уже убил судью и захватил город. 
Угыл. 	Вставай. 
Угыл. 	Вставай! 
Шьыжьымҭан сдәықәлоит Франциаҟа, Исыхьчарц ҳара ҳзинқәа. 	Утром я уеду во Францию, чтобы отстаивать наши права там. 
Уара ара уаангыланы иқәх аметеж, еилыукаау? 	И я оставляю тебя здесь, чтобы ты подавил это маленькое восстание. 
Еилыукаау? 	Понял? 
Знымзар зны уара укрылхоит. 	Однажды ты станешь королем. 
Уҽазкны уҟаз крылс аҟазаара, ахымҩаԥгашьа ҵа акрыл иеиԥш. 	Так постарайся вести себя, как король. 
Бысҟәаҵ! Бысԥырхагамхан 	А ну прочь! 
Еидыскаларц арратә хеидкыла. 	Соберите мой военный совет. 
Сара агәраганы сыҟоуп шәхаҵа дашдәықәло Шоҭландиаҟа. 	Я надеюсь, ваш муж отправится в Шотландию. 
Диԥыларц Уалас. 	встретит Уоллеса, 
Нас шәара шәыԥҳәсибахоит. 	и вы станете вдовой. 
Абаан иахыҟоу. 	Вон там. 
Шәрышҭыл. 	За ними. 
Шәаҳҿамгылан, шәара шәмаҷуп, шәаанкылоуп. 	Нет смысла сопротивляться, вы окружены. Попались? 
Агьырҭ абаҟоу? Уалас дабаҟоу? 	Где остальные? Где Уоллес? 
- Саб. - Уиҩнал,уиҩнал. 	- Отец. - Заходи, заходи. 
Аметеж иалагеит. 	Началось восстание. 
- Иахагылада? - Баша дуаҩуп, Уилиам Уалас. 	- Кто главарь? - Простолюдин. Уильям Уоллес. 
Уара иудгылоит аметеж. 	Воспользуйся этим восстанием. 
Ҳадгьылқәа ашьхарахь ишьҭоу ицхрааит Уалас. 	Окажи ему поддержку на севере. 
Агаҽа ишьҭоу адгьылқәа сара ирԥынсыргылоит. 	Я получу расположение англичан, осудив его, 
Нас исоуеит аҭып аанкылара. 	и приказав выступить против него в наших землях на юге. 
Утәа, хәыҷык уааҭгыл. 	Сядь. Побудь немного. 
Убри Уалас. 	Этот Уоллес... 
Даамсҭаӡам аха иара дырҿагылоуп. 	кажется он даже не имеет рыцарского звания, 
Гәеизҳарала! 	но он сражался страстно! Он вдохновляет. 
Нас уара иуҭаххама уцарц еибашьра, уасами? 	Хочешь сражаться также, как и он? 
- Саргьы исҭахын. - иҟалап аамҭа ааизыр. 	- Я тоже. - Может пришло время. 
Ари аамҭа ԥсра цәцароуп. 	Время выживать. 
Уара – жәибыжтәи Роберт Брус. 	Ты - семнадцатый Роберт Брюс. 
Уабдуцәа ирылшеит ауҭара адгьылқәеи атитулыи,избан акәзар дара еибашьӡомызт. 	16 до тебя передали тебе землю и титул, потому что не вмешивались. 
- еизга аамсҭцәа рхеилак. - Дара баша ибарбароит. 	- Собирай благородный совет. - Они только болтать горазды. 
Хыӡҳәала. Шоҭландиатәи адгьылқәеи атитулыи рыда, дара ирымоуп Англиатәи, ҳара ҳҟны еиԥш. 	Во истину. Они имеют титул и землю в Англии, как и в Шотландии. 
Уара дџьоушьоит Уилиам Уалас. 	Ты восхищаешься этим Уильямом Уоллесом. 
Аизааигәаратә ауаҩ ида имарианы дџьоушьар ҟалап. 	Бескомпромиссными людьми легко восхищаться. 
Алагьы иамоуп агәымшәара. 	У него есть отвага, как и у собаки. 
Анаԥаҿы аизааигәара анагара. Абри иакәҵәҟьоуп ауаҩ аамсҭа. 	Но именно умение договариваться делает человека благородным. 
Иухаумыршҭын, 	И пойми вот что: 
Едуард ашьапҩзы зегьы рацкьыс рыцҳашьара злам 	Эдуард Длинноногий самый безжалостный король 
кралуп Англиа шьакәгылеижьшьҭеи. 	за всю историю английского трона. 
Ҳара ҳаҟнытәгьы, 	И никого из нас, 
Шоҭландиа аҟнытәгьы акгьы аанхаӡом, 	ничего от Шотландии не останется, 
ҳара ҳшыҟу ҳҟамлар. 	если мы не будем такими же безжалостными. 
Урызҽлымҳаз ҳа ҳаамсҭцәа. 	Прислушайся к нашей знати. 
Агәыргьын уоурц азы, 	У знай, что они думают, 
иудыруазароуп дара ргәаанагара. 	и в этом - ключ к трону. 
Уангыл, уԥши 	Стой. Смотри. 
́ари адәахьала, ари армарахь. 	Это сюда, а это - слева. 
Шәаала, Шәаала. 	Пошли. 
Акрал даныхынҳәлак, иара иижоит дара, абри ҿыцмаҭәала. 	Когда король вернется, он похоронит их в этой новой одежде. 
Шоҭландиа хынҭаҩныҭароуп. 	Шотландия в хаосе. 
Шәара шәхаҵа ар иишьҭоит ашьхарахь. 	Ваш муж посылает тайно армию на север. 
Иалбдыраауеи бара? 	Откуда ты знаешь? 
Иацауха сара сицшьҭан арратә хеидкыла алахәыла. 	Прошлой ночью я переспала с членом Военного Совета. 
Иаԥсамызт иара иаҳәара, амаӡақәа акаруаҭ аҿы. 	Не стоило ему рассказывать секреты в кровати. 
Аеи нас. 	Да уж. 
Абарҭ Англичанцәа ирыздырӡом изырҭаху абыз. 	Эти англичане не знают зачем нужен язык. 
Абри Уаллас дшоҭланд-уаҩуп, 	А этот шотландец Уоллес, 
Иара дықәԥома аԥҳәыс лшьа иурц? 	он сражается, чтобы отомстить за женщину? 
Сара ԥсык сыгхеит исхашҭырц. 	Я чуть не забыла. 
Аӡбаҩ иҭахын дааникылар иара. 	Судья хотел захватить его 
Нас идырт, иара дашимаз маӡала ацәыбза 	и узнал, что у него была тайная любовница. 
Абасала иара иԥиҟеит аӡӷаб лыхәда, 	Так что он перерезал девушке горло, 
Уаллас аибашьрахь иааԥхьаразы , 	чтобы вызвать Уоллеса на бой. 
Нас иара диԥхьеит. 	И он его вызвал. 
Ишидыруаз иара агәазыҳәараӷәӷәа шимоу ицәыӡыз ибзиабаҩ лахь 	Зная его страсть к потерянной возлюбленной 
Дара ирыӡбеит д-дырбаандаҩыртәыр, 	они решили захватить его, 
Ихьымӡӷыркит иаби иашьеи рнышәынҭрақәа, 	осквернили могилы его отца и брата, 
Нас иахаҩеит ибзиабаҩ лнышәынҭра. 	и оставили засаду на могиле возлюбленной. 
Аха иара дампыҵҵит ацәҟьа. 	Но он вырвался из ловушки 
Нас иеигоит аԥсыбаҩ уаҩы иахизымдыруа аҭыԥахь. 	и отнес ее тело в тайное место. 
Абри ауп абзиабара,ииашами? 	Вот это любовь, правда? 
Абзиабара? 	Любовь? 
Сара исыздыруам. 	Я не знаю. 
Иаарласны ашьапҩзы аҩадатәи ир, иҟалоит абра. 	Знаешь, в конце концов 
Иаарласны ашьапҩзы аҩадатәи ир, иҟалоит абра. 	Длинноногий пошлет свою северную армию против нас. 
Иҟалап акавалериа, ихашәҵа иара иҟнытә адгьыл ҵасоит. 	Тяжелая кавалерия, всадники в доспехах. Земля будет сотрясаться. 
- дара ҳара ҳақәырхоит. - Саб иашьа Аргаил исеиҳәон. 	- Он растопчет нас. - Дядя Аргил рассказывал об этом. 
Акавалериа хьынҭа ҳзаиааиуам ҳәа. 	Что ни одна армия не может выстоять против тяжелого всадника. 
- иҟаҳҵои нас? - Уис, уҩ, уҽыҵәах, ашьхаруаа рҽаҭахьы ражәахьа. 	- Так что нам делать? - Напасть. Убежать. Скрыться. 
Ҳара иҟаҳҵоит хыци-хымпали. 	Или сделать копья. 
Шәкыла хыци-хәымпалқәа аура ҩыџьа ауаа рышәара аҭаны. 	Сотни длинных копьев. Вдвое длиннее человека. 
- Убри аҟара иаунуу? - Ааи. 	- Такие длинные? - Да. 
Ауаа зегьы рышәага еиԥшым, аӡә даууп, даҽаӡәы дкьаҿуп. 	Так люди же разного роста. 
Уара уан дырҩагьых сара дсылацәажәозма? 	Что, твоя мама снова рассказывала истории про меня? 
Хатәгәаԥхаралауаа ааит . 	Добровольцы пришли. 
Уилиам Уалас, ҳара ҳааит ҳарҿагыларц насгьы ҳаԥсы ҭаҳхырц уара узы. 	Уильям Уоллес, мы пришли сражаться и умереть за вас. 
Сара папа рим сакәӡам, угыл. 	Встань. Я же не Папа Римский. 
Сара исыхьӡуп Форџьен. Сара саҳәа уара уаҳәоуп. 	Меня зовут Фодрон. Мой меч принадлежит вам. 
- абри, сара шәара, ишәзазгеит. - ҳара дара еимаҳдахеит. 	- Вот это я принес вам... - Мы уже обыскали их. 
Сара иаазгеит … 	Я привез вам это. 
- ҳара еилаҳкаахьеит, дара бжьарда иҟоуп. - Сара иузаазгеит …… ари сыԥҳәыс лоуп иҟазҵаз. - Иҭабуп. 	- Моя жена сделала для вас. - Спасибо. 
Убри! Уилиам Уалас иакәымхар ҟалап. 	Он! Этого не может быть. Уильям Уоллес. 
Сара иара иацкьыс сыгәкуп. 	Я красивее его. 
Ибзиоуп саб, сара сиазҵаауеит. 	Ладно, отец. Я спрошу его. 
Сара исоуеит аҭагылазаашьа имарианы Англызцәа рышьра, 	Если я буду рисковать своей шеей из-за тебя, 
Изгәаӷьыр схы уара узыҳәан? 	получу ли я шанс убить англичан? 
Уаб анаур деиԥшума ма анцәаду уиацәажәо? 	Твой отец призрак или ты беседовал с Всевышним? 
Иуаԥхнагалоу дуԥшаарц азын Аирландуаҩ мчымхарыла диацәажәароуп анцәа. 	Чтобы найти себе равного ирландцу приходится разговаривать с Богом. 
Ааи, саб. 	Да, Отец. 
Анцәа иҳәеит: 	Всевышний говорит: 
"иҳәа аҭак аҩсҭаа изҵаатәқәа, нас иумԥсахкәа аҵакы"! 	"Не меняйте тему, просто отвечайте на чертовы вопросы"! 
- Ашьшьыҳәа. - Аирланд бзамыҟәа! 	- Следи за языком. - Безумный ирландец! 
Аҟаруал ирывганы аҟама аиагара сылшазар, ишԥа саб. 	Но достаточно умен, чтобы пронести кинжал мимо твоих стражников. 
ари са дасҩызоуп, Аирланд. 	Это мой друг, ирландец. 
Аҭак уара узҵаара. Ааи. 	А ответ на твой вопрос - да. 
уареи сареи ҳарцеиҽагылоит. Англызцәа ушьлоит. 	Сражайся за меня и ты сможешь убить англичан. 
Даара ибзиоуп. 	Превосходно. 
Сара исыхьӡуп Сҭивен. 	Меня зовут Стивен. 
Зегьы рецкис изышьҭоу сара соуп. 	На моем острове меня повсюду разыскивают. 
Аиаша сара уажә сыдгьыл бжьаха аҽакәӡам сахьыҟоу. 	Конечно, сейчас я не на своем острове. 
- Ари рыцҳашьароуп. - Адгьыл бжьаха уара утәоума? 	- И очень жаль. - Твой остров? 
Ааи иара сара истәуп. 	- То есть Ирландия? - Да. Он мой. 
Ухы уақәиҭӡым. 	Ты безумец. 
Сааит иахьахәҭаз. 	Тогда я попал в нужное место. 
Анцәа ду сааишьҭит усыхьчарц уара. 	Конечно, не Всевышний послал меня следить за тобой. 
иара ахаангьы дысгәаԥхомызт. 	Он мне все равно не нравился. 
Иара ихы дақәиҭӡымызт. 	У него с головой было не в порядке. 
Уилиам … ҳара ҳаԥшыхәҩцәа 	Уильям. Наши гонцы. 
Уилиам … Англызцәа рыруаа азааигәахоит Стерлинг ахь. 	Англичане выдвинули войска на Стерлинг. 
Аамсҭцәа рҽеизырган. 	Дворяне собрались? 
Роберт Брус аиҳараҩык аамсҭцәа рҽазыршәом ақәылара. 	Роберт Брюс и прочие не будут сражаться. 
Уҳәан-сҳәан рылаҵәан, нас ирацәахеит ашьхарыуаа, 	Но известие распространилось. Горцы собираются сами по себе. 
шәҩыла, зқьҩыла. 	И они собираются сотнями и тысячами. 
Шәа шәмазеиума уқәларахь? Ааи. 	Вы готовы к войне? 
Стерлинг 	Стерлинг 
Ажәабжьс иҟои? 	Какие новости? 
Дара рацәаҩуп, еиҳарак хынтә. 	У них перевес сил минимум трое к одному. 
- Заҟа ҽы ыҟоузеи? - Хышә еиҳазаргьы ҟалап. 	- Сколько лошадей? - 300, может больше. 
- Хышә ҽы? - Ҳаиасып аицәажәарахь. 	- 300 тяжелых лошадей! - Мы должны попробовать поговорить. 
Дарбану еиҳабу?Хышә ҽы! Дара ирымоума ашеврон ҟаԥшь? 	Кто командует? У него был алый шеврон? 
- Дара ирымазар ҟалап ашәаҳәа? - Аии, сара исыԥхьаӡоит аицәажәарахь ҳаиасып ҳәа. 	- Да, был. - Тогда это Челтем. 
Иаҭахуп аицәажәара. 	Но мы еще можем договориться. 
Излацәажәои дара? 	О чем они говорят? 
Исаӡом, аха иубартә иҟоуп аус шбашоу. 	Я не слышу, но мне это не нравится. 
Дара аицәажәарахь инеиуеит. 	Знать будет договариваться. 
Еинаалар, аҩныҟа ҳцап. 	Они договорятся, и мы пойдем домой. 
Мап анакәха, ҳрыжәлоит. 	Если нет, мы атакуем. 
Ҳа иҳамаӡам имариоу ашанс. 	300 тяжелых лошадей. У нас нет шансов. 
Дара убасҟак ирацәоуп. 	Так много. 
Сара исҭахӡам сҭахар аамҭцәа ироурц адгьылқәа ирацәаны. 	Я пришел сюда сражаться не за то, чтобы они получили больше земель. 
Иашоуп. 	Тогда придется работать на них. 
Аӡәы ииҭахуп, 	Не хочу. 
дҭахарц абарҭ ахәымгақәа рзы. 	Ладно, ребята, я не буду умирать за этих ублюдков. 
Ҳгьежьып. 	Пошли домой. 
Шәаангыл, 	Стойте, люди! 
шәымцан, шәаангыл аицәажәара нҵәаанӡа. 	Не бегите! Подождите до конца переговоров. 
- Уилиам Уалас? - Агәрасызгом … дкьаҿцәоуп. 	- Уильям Уоллес! - Не может быть. Такой низенький. 
Анцәа ду ииҳәоит ари даара ибзиаӡоу қәылароуп. Иара еднакылт иреиӷьӡоу ауаа. 	Всевышний говорит, что это почетная битва. Она собрала лучших людей. 
Иабаҟоу аԥсшәа еибыҳәара? 	Где твое приветствие? 
Сара иҭабуп ҳәа шәасҳәоит, шәара абраҟа шәахцәырҵыӡ аибашьра адәаҟны. 	Благодарю тебя, что прибыл на поле боя. 
Ари ҳара ҳар ауп. Уара ҳаидыумҵаӡеит, 	Это наша армия. Принеси присягу, чтобы вступить в нее. 
Сара еидысҵеит Шоҭландиа. 	Я принес присягу Шотландии. 
Ари шәара шәыр акәзар, 	И если это твоя армия, 
изцози иара шьҭахҟа? 	почему она бежит? 
Аӡәгьы иҭахӡам дҭахар аамсҭцәа рзы. 	Мы пришли не для того, чтобы сражаться за них. 
ҳгьежьып, англызцәа рацәаҩуп. 	Домой. Англичан слишком много. 
Шоҭландиа аԥацәа! Сара Уилиам Уалас соуп. 	Сыновья Шотландии! Я - Уильям Уоллес. 
- Уилиам Уалас 2-метрак деиҳауп. - Ааи исаҳаит. 	- Уильям Уоллес ростом два метра. - Да, я слышал. 
иршоит шәаҩыла аӷацәа. 	Он сотнями убивает людей. 
Иара абра дыҟазар, иқәихон Англызцәа лаԥшыла, 	Если бы он был здесь, он бы истребил англичан одним взглядом 
нас идәықәиҵон амацәыс еиԥш иашьҭахь ала. 	и громом от своего зада. 
Сара Уилиам Уалас соуп. 	Я и есть Уильям Уоллес! 
Сара избоит ар дуӡӡа, дара зегьы сыуаажәлар роуп, 	И я вижу целую армию моих соотечественников, 
изыӡбыз аиуара атераниахь. 	борцов с тиранией. 
Шәара шәааит ақәԥара зхы иақәиҭу ауаа реиԥш, 	Вы пришли сражаться, как свободные люди. 
шәарҭ ус шәагьыҟоуп. 	Вы и есть свободные. 
Ахақәиҭрада ҳара ҳбашоуп. 	Что вы будете делать без свободы? 
Шәара шәаҽагылома? 	Будете сражаться? 
Мап … ҳара иаҳҭахӡам аибашьра. 	Против них? Нет. 
Мап. Ҳара ҳабналоит, ҳаԥсы ҭазаауеит. 	Мы убежим и выживем. 
Уқԥа. уара иҟалоит уԥсыр. 	Да. Сражайтесь и можете погибнуть. 
Убнал, уԥсы ҭазаауеит. 	Бегите и выживете. 
аамҭанык. 	Какое-то время. 
Акыр аамҭа анҵлак шәанԥсуа шәиарҭаҟны, 	Но умирая в своих кроватях, много лет спустя, 
шәара ишәҭаххоит арханҳәра, 	захотите ли вы обменять 
арҭ ашықәсқәа зегьы, 	все дни после сегодняшнего 
шанск азы, еидкыланы шанск азоуп. 	на один шанс, всего один шанс, 
шәара шәгежьны ирашәҳәа ҳаӷацәа, 	чтобы вернуться сюда и сказать врагам, 
ахаангьы ҳаԥсҭазаара ҳамырхыргьы 	что они могут забрать наши жизни, 
ахақәиҭра шәызҳамхӡом. Ахақәиҭра … Ахақәиҭра ҳара ҳхақәиҭра … Шоҭландиа ахақәиҭра. 	но не смогут забрать нашу свободу. 
Дара ирымоуп агәыӷра. 	Они весьма оптимистичны. Может они и впрямь хотят сражаться. 
Иҟалоит аибашьра. Аидыслара хымԥада иҟалоит, 	Столкновение - это неизбежное следствие. 
шәхаҵкы, аха зны ираҳәатәуп акрал игәазыҳәарақәа. 	Но, тем не менее, нам стоит доставить условие короля. 
Сара агәра згоит дара ирыдыркылаӡом иара игәазыҳәарақәа. 	Они никогда не согласятся на них. 
Шәхаҵкы. Сара сгәы иаанагоит … 	Мой господин, я думаю... 
Аеи нас шәҽазышәшәа, аидгалара 	Ну ладно. Предложите им условия. 
Сгәанала ҳарԥылароуп дара. Азин сышәҭ сара сцәажәоит. 	- Они выехали. Поехать им навстречу? - Позволь мне вести переговоры. 
Ибзиоуп. 	Хорошо. 
Даара ибзиоуп ицәажәара, 	Прекрасная речь. 
нас уажәжьҭа иҟаҳҵои? 	Что нам теперь делать? 
Ҳаанхап ҳа ҳшыҟоу. 	Просто быть самими собой. 
- Уабацои уара? - Исҭахуп аидыслара сыдыскылар. 	- Куда ты? - Собираюсь принять бой. 
Исҭахуп среисыр. Нас баша ҳҽеилаҳамҳәеит. 	Ну, мы же не просто так раскрасились. 
Морне, Локлан, Крег. 	Морней, Лохлан, Крейг. 
Ари акрал игәазыҳәароуп, 	Вот условия короля. 
иқәжәга шәыр аибашьра адәы аҟнытә. 	Уведите свою армию с поля, 
Нас шәыззагьы ишәоуеит адгьылқәа Иокшер аҿы. 	и каждому из вас он пожалует поместье в Иоркшире, 
Насгьы шьҭралатәи атитулқәа. Убри азыҳәан … 	включая наследный титул, с которого вы будете платить... 
- Убри азыҳәан, аҟәрышь ахшәаатәуп есышықәса. - Сара исымоуп ажәалагала, 	- С которого вы будете платить... - У меня есть предложение. 
Челҭон. Ари Уилиам Уалас … 	Челтем, это Уильям Уоллес. 
шәара есышықәса аҟәрышь ишәҭалоит акрал. 	С которого вы будете платить королю... 
- Сара исымоуп, сҳәеит ажәалагала. 	- Я сказал, у меня есть предложение. 
Пату ақәуҵаӡом уара аиналара абираҟ. 	- Ты не уважаешь знамя переговоров. 
Абри икрал иҟнытә? Зынӡа. 	От его короля? Совершенно верно. 
Абар Шоҭландиа агәазыҳәарақәа. 	Вот условие шотландцев. 
Илашәышьҭ абираҟқәа. Нас шәханҳәы Англиаҟа, 	Опустите ваши флаги и отправляйтесь обратно в Англию. 
ҩныцыԥхьаӡа шәнеины аҭамзаара шьҭашәҵа, 	Но у каждого дома, мимо которого будете проезжать, 
шәышықәсатәи шәқәыларақәеи, аҳәса рцәаԥҽреи, ауаҩшьрақәеи рзы. 	просите прощения за 100 лет разбоя, насилия и убийств. 
Убас иҟашәҵар шәыр рыԥсы ҭазаауеит, 	Выполните это, и ваши люди выживут. 
иҟашәымҵар зегьы абра шәыԥсоит. 	Не выполните, и каждый из вас сегодня погибнет. 
Шәара даара шәмаҷуп. Шәара ишәымаӡам ихьанҭу ковалериа. 	Вас же слишком мало. И у вас нет тяжелой кавалерии. 
Ҩышә шықәса рыла зныкгьы шәзымаиааиӡит. 	За два столетия ни одна армия не побеждала... 
Сара саламгаӡацт, 	Я не закончил! 
шәара шәоуҳашьҭаанӡа, 	Перед тем, как мы отпустим вас, 
шәеиҳабы абри адәы дахысны ҳар рҽаԥхьа 	ваш командующий должен перейти это поле, предстать перед этой армией, 
даагыланы ихы кылеиҳәоит итәаӷәбжьара, нас иаҳә дагәӡоит. 	засунуть голову себе между ног и поцеловать себя в зад. 
Иара дашьццылаӡам ари аҩыза ихьшәашәадкылара. 	Думаю, он привык к более сердечному обращению. 
Шәгәашәҽаныз абас аҟаҵара … сара сдырраҭарала, 	Будьте готовы делать то, что я скажу, по моему сигналу. 
шәара Англызцәа шәрывсны шәнеиоит дара ахьыҟоу. 	Объезжайте нашу позицию и заходите с фланга. 
- ҳәара ҳамчқәа еиҟәшәар ҟалаӡом. - Иҟашәҵа. 	- Мы не должны разделять войска. - Сделайте это. 
Нас англызцәа убри рбааит. 	И пусть англичане это заметят. 
Ҳаҩны ҳца џьыршьоит. 	Они подумают, что мы бежим? 
ижәга ахымпалы аршәҩцәа, сара сшәызԥшызаауеит. 	Затем уничтожьте их лучников. Встретимся посередине. 
Ибзиоуп. Ҳдәықәшәҵа. 	Хорошо. Поехали. 
Цәгьаԥхамшьа. Исзажәга абра Уалас игәы ҭыхны. 	Кичливый ублюдок! Я хочу голову этого Уоллеса на блюде. 
Ахыци ахымпалы ахысыҩцәа, ахыци ахымпалы ... 	Лучники. 
ахысыҩцәа! 	Ублюдки! 
ԥхьаҟа. Шәиас ԥхьаҟа. 	Пускай. 
ҳазшаз иҳәеит салахоит абри аханҭа-ҩынҭара. 	Господь подсказывает мне, что он выведет меня из этой стычки, 
Уара уашәа нагӡоуп. 	но еще он уверен, что ты псих. 
шәықәҵ. 	Готовы? Пускай! 
Шәыҩ. 	Скачите. 
Ажәлар ижәба Ашоҭландцәа иқәҵны ацара ишаҽу. 	Видите? Даже шотландские всадники бегут. 
Ҳара ҳкавалериа ирыцҟьоит дара аҳаскьын ҿа еиԥш. 	Наша кавалерия стопчет их как траву. Посылайте конницу. 
ишәшьҭы аҽыҩцәа. Инагӡаны ажәылара шәалага. Аҽыҩцәа ԥхьаҟа 	Полная атака. 
Шәыҽшәырмазеи! 	Готовьтесь! 
ҳаԥшуп! 	Держись! 
ҳаԥшуп! 	Держись! 
ҳаԥшуп! 	Держись! 
ҳаԥшуп! 	Держись! 
шәалааа! 	Взяли! 
- ашьаҟауаа шьҭы. - шәхаҵкы ... 	- Посылайте пехоту. - Мой господин... 
уара ԥхьаҟа иугоит. 	Ты поведешь их. 
Ашьаҟауаа шәҽазыҟашәҵа. Ҳарԥырҵоит 	Отступаем! 
алахша! 	Ублюдок! 
ԥхьаҟа! 	Вперед! 
даара ибзиоуп. 	Отлично. 
Уалас. 	Уоллес. 
Уалас, Уалас… 	Уоллес. 
еизыккоит Уилиам Уалас иаамсҭара, 	Посвящаю тебя в рыцари, 
Аамсҭа Уилиам Уалас. 	сэр Уильям Уоллес. 
Аамсҭа Уилиам! Анцәа ихьӡала 	Сэр Уильям, именем Господа 
уара иуаҭәаҳшьоит Шоҭландиа еиқәырхаҩык, 	мы назначаем тебя стражем и высоким защитником Шотландии, 
иасгьы хьчаҩык еиԥш. 	а твоих военачальников адъютантами. 
шәгыл уи ус иҟалоит. 	Вставай и прими свое звание. 
Аӡәыр идыруама иара игәаанагара? 	Кто-нибудь знает его политику? 
Мап, аха иара инырра ауаа рышҟа зегьы рзы иаанагоит аиҭакапанра. 	Нет, но его влияние на простолюдинов может все расстроить. 
Ирҭахымкәа иара икәхшалоит, иара ҳаргьы. 	Балиоль будет целовать ему задницу, так что нам тоже придется. 
Аамсҭа Уилиам! Аамсҭа Уилиам! 	Сэр Уильям. 
уареи уара ур уааи аобласть аҟнытә 	Так как ваши военачальники и вы происходите из района, 
ажәытә-натә аахишьҭеи идгалаҩцәа клан Балио, 	который давно поддерживал клан Балиолей, 
Ҳара иҳалшома шәара шәыцхыраара насгьы наҟ-наҟ 	можем ли мы пригласить вас возобновить поддержку 
ҳара ҳаԥҟарақәа аанхарц азы. 	и поддержать наши законные притязания? 
Аҩсҭаацәа дырфааит Балиоли. Дара ашьапҩзы ицааит. 	Черт побери клан Балиолей! Они все люди Длинноногого. 
Шәхацкы! 	Джентльмены. 
- Иааит аамсҭа. - ихьӡ ҳәара акрал. 	- Джентльмены. - Пришло время провозгласить короля. 
Мап, мап. Шәаангыл. Иаанагоит шәара шәазыхҩоуп азакәан аԥҟара адкылара ҳара ҳаицлабҩы. 	Подождите. Вы готовы признать наше законное наследие? 
- Шәара енагь азакәан аԥҟарақәа шәырҽагылан. 	- Вы не поддержали законного короля. 
- уа иану уи имцӡами? 	- Это ложь, которую ты сам состряпал. 
О мап. 	Нет. 
- Уа зегь иашоуп. Сара сгәы азыҳәара рацәоуп. - Абарҭ ашәҟәқәа рышьақәргылара. Уа зегь мцуп. Шәара зегьы жәдыруеит. Зегь мцуп. 	- Я требую признания документов. - Ты сам состряпал эту ложь. 
Сшәыҳәоит иҟалозар шәхацкы. 	Пожалуйста, джентльмены. 
Шәангыл аамсҭа Уилиам. Шәабацои? 	Тише. Сэр Уильям. Куда вы? 
Ҳара иаҳҟәыбеит Англызцәа, 	Мы победили англичан. 
аха дара гежьоит. Шәара аидгылара ишәҭахӡам. 	Но они вернутся, потому что вы не держитесь друг за друга. 
- Шәара ишәҭахи? - Сара Англиаҟа сцаны, 	- Что вы сделаете? - Я вторгнусь в Англию 
нас дара убра инсырҵәоит. 	и уничтожу англичан на их земле. 
Изалыршахом уахь анеира, ааи! 	Вторжение? Это невозможно. 
Иуазеи изаламыршахәа? 	Почему? Почему это невозможно? 
Шәарҭ шәахӡыӡаауеит, шәазықәԥоит ахәаша аишәа аҟнытә ииршәо ашьапҩзы, 	Вы так озабочены ссорами за объедки со стола Длинноногого, 
ишәхашҭит азин анцәа ду ишәиҭаз. 	что вы променяли ваше Богом данное право на что-то получше? 
Убри ауп ҳара ҳазмырҩашьуа. 	Между нами есть разница. 
Шәара шәтәала ажәлар 	Вы считаете, что народ Шотландии существует, 
шәҭагылазаашьа еибырҭоит, 	чтобы поддерживать вас в вашем положении. 
аха сара уисыԥхьаӡоит шәҭагылазаашьа иҟоу 	А я считаю, что ваше положение существует, 
ианаҭоит ажәлар ахақәиҭра. 	чтобы поддерживать свободу народа. 
Иара убри азоуп сара сызцо убрахь. 	И я позабочусь, чтобы она у него была. 
Ииҳәо закәи? Иара зынӡаск ихы еилагеит. 	Постой. 
Шәаангыл! Сара шәеилыскаауеит. 	Я уважаю то, что ты сказал, 
Аха ишәхашәмыршҭын дара ирымоу адгьылқәеи абаашқәеи, 	но пойми, у этих людей есть земли и замки. 
дара рзыҳәан ари агәаӷьроуп. 	Им есть чем рисковать. 
Аибашьра адәаҟны ауаҩ агәаӷьра 	А простолюдин, который истекает кровью в бою, 
имоу маҷума? 	разве он меньше рискует? 
Мап … аха ахдырра ари атәылаҟны зынӡа иамаӡам. 	Нет, но сверху донизу в этой стране нет чувства достоинства. 
Аҭауадеи Англиеи аимадара рыбжьоуп, 	Знать сохраняет верность Англии. 
- ажәлақәа еибашьоит дара-дарала. - Ааи. 	- Кланы воюют друг с другом. - Да. 
Рыҩџьа рыбжьара иҟалар аӷацәа, шәара шәыԥсуп. 	Если ты создашь врагов по обе стороны границы, ты погибнешь. 
Нас ҳаззагьы ҳаԥсоит. Азҵаара ишԥа нас иззакәи? 	Все в конце концов погибнут. Вопрос только как и зачем. 
Сара сшәаӡом. Сара ара исҭахуп 	Я не трус, я хочу того же, что и ты. 
аха аҭауадцәа иаҳҭахуп. 	Но нам нужна знать. 
- Ииашану? - Аеи. 	- Нужна? - Да. 
аҭауадцәа. Иселшәыркаа дазусҭада аҭауад? 	А теперь скажи мне, что значит быть благородным? 
Шәара шәтитул ишәнаҭоит азин апрестол ахь анеира. 	Твой титул дает право на трон нашей страны, 
Зегь рацкьыс ихадоуп атитулқәа, 	но ведь люди не идут за титулами. 
ажәлар дәыкәлоит ахаҵарахь. 	Они идут за смелостью. 
Ажәлар шәырдыруеит шәара. Ауаа башақәеи аҭауадцәеи ишәхьԥшны 	Теперь наши люди знают тебя. Знать и простые люди уважают тебя. 
ицозар аиаша мҩахь насгьы аҭынчра мҩа ахь, 	Если ты поведешь их к свободе, 
дара имхәыцӡакәа ишәышьҭаланы ицоит, 	они последуют за тобой. 
иара саргьы сцоит. 	И я тоже. 
Аҩсҭаа … аҩсҭаа … ари сахәшьаԥа амаҳагьа ииҩоит 	Черт возьми. Этот содомит, мой кузен принц, говорит, 
исиҭом ар, 	что не может одолжить мне войска. 
аха аҩадатәи Англиа иаарыԥхьоит ацхыраарахь. 	И каждый город в северной Англии молит о помощи. 
Иара джәылоит. 	Он наступает. 
- Иарбану қалақьу? - Арахь шәхацкы. 	- На какой город? - На этот, мой господин. 
Днага аҩнуҵҟа, акрал ҩбашәтә, агәашәқәа ашәыркы, шәласы. 	Все припасы и пищу внутрь, удвоить стражу на стенах, 
агәашәқәа ашәыркы. 	закрыть ворота, живо! 
Шәласы, шәласы. 	Быстро! Заносите провизию. 
Шәхаҵкы! Ҳара араантә шәалҳгар ҟалоит, 	Сэр, мы можем вывести вас, но только сейчас. 
сара изысцҳароуп саб иашьа изысцәыӡыз иреиҳаӡоу ақалақь аҩадатәи Англиа. 	Я не смогу сказать дяде, что потерял самый великий город северной Англии. 
ԥхьаҟа! 	Вперед! 
Амҩа ишәҭ акрал! 	Дорогу королю! 
Ари уара иухараӡам. 	Это не ваша вина. 
- Иҳәа уара угәаанагара. - сара исҳәоит сгәаанагара иҵегьы иацҵаны. 	- Выйдите к нему. - Я выйду к нему. 
Ажәабжьыс иҟоузеи? 	Какие новости из севера? 
Акагьы, 	Ничего нового, Ваше Величество. 
ҳара иаҳшьҭит аҽыҩцәа иааргарц ажәабжь ҽыцқәа. 	Мы послали гонцов, чтобы донести все известия. 
Сара исаҳаит, Франциа, 	Я слышал известие во Франции, 
Сахықәԥози иахьеиҳастәози уара уаԥхьатәи уԥеиԥш иумпыҵаку адгьыл. 	где я сражался за расширение твоего будущего королевства. 
Сара исаҳаит сыҷқәын, аха ҳара зегьы аҩадатәи ҳар иҟәыбаса еилажьуп, 	И мне сообщили, сын мой, что вся наша северная армия уничтожена. 
нас уара акгьы узыҟамҵаӡеит. 	И ты ничего не сделал. 
Сара иазгеит асолдаҭ гуԥҩык дара иеиқәшәоуп аибашьрахь ацара. 	Я объявил воинский призыв, сэр. Новобранцы собраны и готовы. 
Саҭамзааит шәхаҵкы! Ирццакны ашьҭра Иоркантә. 	Простите, сир, но из Йорка срочное донесение. 
Уааи ара. 	Давай. 
- Ҳааныжь ҳара. - Ааи шәхацкы. 	- Ступай. - Благодарю, сир. 
- Уалас иицҟьеит Иорк. - Изакәи? 	- Уоллес взял Йорк. - Что? 
Уалас иицҟьеит Иорк. 	Уоллес взял Йорк. 
Шәхацкы! Шәара шәаҳәшьаԥа. 	Сир, это ваш племянник. 
агыгшәыг иҟаиҵазеи? 	Какой зверь мог это сделать? 
Иара Иорк импыҵеихалазар, 	Если он может взять Йорк, 
днеир ҟалоит агаҽатәи Англианӡа. 	он может вторгнуться в нижнюю Англию. 
иара ҳара даанаҳкалоит. 	Мы остановим его. 
Дарбан ари ауаҩ изҳәо сара исҭахәшәа иара ицхыраара алабжьараҿы? 	Кто это говорит мне, будто я нуждаюсь в его совете? 
Сара Фелеп дахасыргылт ихадоу бжьгаҩыс. 	Я назначил Филиппа моим высоким советником. 
Иара имч азхо? 	Он сведущ в этом? 
Сара адырра сымоуп аибашьраҟны. 	Я знаю искусство войны, военную тактику, сир. 
Ииашаны? 	Правда? 
Нас исаҳәа … 	Тогда скажи... 
иарбан абжьгарас исуҭоу, Уажәы аҭагылазаашьа? 	Какой совет ты дашь в нынешней ситуации? 
Сара иабжьазгоит аинаалара, 	Я предложу мир 
насгьы даасхоит. 	и куплю его. 
Ицода иара иахь? Сара сакәӡам. 	Но кто поедет к нему? Не я. 
Иара иаҳәа саҽашәар, 	Если я паду от меча этого убийцы, 
схы акалаҭ иҭаҳар ҟалап. 	то в ведре окажется моя голова. 
Сара сыҷкәын ԥшқа иакәӡам. 	И не мой благородный сын. 
Иԥшра заҵә инаҭоит агәахәара иаӷа икра атәыла зегьы аҟны. 	Один вид его лишь вдохновит врага захватить всю страну. 
Нас исшьҭода? 	Так кого мне послать? 
Исшьҭода? 	Кого мне послать? 
Ари ԥхыӡума? 	Это сон. 
Ааи ԥхыӡуп. 	Да, сон. 
Уааԥшыроуп уажәшьҭа. 	Но ты должен проснуться. 
Ааԥшра сҭахӡам. 	Я не хочу просыпаться. 
Исҭахуп ара сбыцзар. 	Я хочу остаться здесь, с тобой. 
Сара уара суцзар. 	А я с тобой. 
Аха уара уааԥшыроуп. 	Но ты должен проснуться. 
Уааԥшы Уилиам. 	Вставай, Уильям. 
Уааԥшы. 	Проснись. 
Уилиам Уааԥшы. Уааԥшы.. 	Уильям, проснись. 
Уилиам иааит акрал ишьҭымҭацәа. 	Уильям, едет королевская свита 
Еинзраало абираҟала, 	под знаменем переговоров 
насгьы ашьапҩзы идыргала. 	и под штандартами самого Длинноногого. 
Сара Уелз аҳқәажә. 	Я принцесса У эльская. 
Сааит акрал идҵаҟаҵарала. 	Я прибыла, как слуга короля и от его власти. 
Иауазеи? 	Зачем? 
Иҳаӡбырц акрал идҵаҟаҵамҭа. 	Чтобы обсудить предложение короля. 
Шәарҭ аԥҳәыс шәлацәажәома? 	Вы будете говорить с женщиной? 
Сара иахьынӡаздыруа шәара уажәыааигәа ишәырҭеит ахьыӡ аамсҭа. 	Я так понимаю, вам недавно дали звание рыцаря. 
Сара акгьы сыримҭаӡеит. 	Мне ничего не давали. 
Анцәа ду иоуп. Иҟазҵо абас ауаа дара ишыҟоу еиԥшны. 	Бог сотворяет людей, как они есть. 
Ари анцәа ду иоума уҟазҵаз еиларбга ҳәа аҭынч қалақьқәа? 	Бог сделал вас разорителем мирных городов? 
Акрал иаҳәшьаԥа ашьапҩзы, схаҵа иаҳәшьаԥа. 	Палачом племянника короля, кузеном моего мужа? 
Иорк ирыман уасхырс зегь рзы, сара стәыла иқәнагалоз. 	Йорк был отправной точкой для всякого вторжения в мою страну. 
уи аамҭазы акрал иаҳәшьаԥа икнеиҳуан Ашоҭландцәеи, насгьы зынӡа акгьы зхарамыз, ахәыҷқәеи аҳәсақәеи. 	Этот кузен вешал шотландцев, даже женщин и детей на городских стенах. 
Ашьапыҩзы далалеит еиҳа еицәаны, 	Длинноногий поступал намного хуже, 
импыҵахалуа Шоҭландиатәи ақалақьқәа. 	когда в последний раз захватывал шотландский город. 
Иара агәмбылџьбара, алеишәа цәгьа, абнауаҩы. 	Он беспощадный свирепый дикарь. 
Насгьы иара амц иҳәоит. 	И он лжет. 
Сара ахаангьы мцы сҳәаӡом. 	Я никогда не лгу. 
Аха сара ииашаны сыбнауаҩуп. 	Но я и вправду дикарь. 
Иҟалап шәара ишәҭахызар Францыз бызшәала? 	Может быть вы предпочитаете по-французски? 
Шәара ишәҭахызар шәиазҵаар ҟалоит шәара шәкрал, Шәиазҵаа. 	Спросите вашего короля в лицо. Спросите. 
Иара илақәа агәра шәдмаргаӡари. 	И тогда ваши глаза увидят правду. 
Ҳамельҭеи удәылҵ. 	Гамильтон, оставьте нас. 
- Аҳкәажә? - ҳааншәыжь ҳхала, уажәыҵәҟьа. 	- Моя госпожа? - Оставьте нас. 
уажәшьҭа ииашацәҟьаны. 	Поговорим прямо. 
Шәара Англиа шәалалеит. 	Вы вторглись в Англию. 
Аха шәара ишәзыгаӡом иара, 	Но вы не можете завершить завоевание 
избанзар, шәара шәыҟоуп ихараны шәтәыла аҟнытә. 	так далеко от ваших припасов и убежища. 
Акрал иҭахуп аҭынчра. 	Король желает мира. 
- Ашьапыҩзы аҭынчра иҭахуп! - Иара ирылеиҳәеит, шәара ишәымаҿуп. 	- Длинноногий желает мира? - Он так объявил, я клянусь. 
Иара ишәыдигалоит ар наҟ иқәжәгарц. 	Он предлагает вам прекратить наступление. 
Ацынхәрас иара ҳамҭас ишәиҭоит, атитул, адгьыл, насгьы ашәандыҟәра азна ахьы, 	Взамен он даст вам титул, поместье и сундук золота, 
сара хаҭала ишәсыркоит. 	который я привезла вам лично. 
Атитул, адгьыл нас иацҵаны ахьы, уи аамышьҭахь дҟаларц Џьудес. 	Звание лорда, титул и золото за то, чтобы я стал иудой? 
- Ус енагь иҟалоит адунеиаҿы. - Дара атәцәа ракәхон. 	- Так создается перемирие. - Так создаются рабы. 
Ашьапыҩзы даналацәажәоз аҭынчра, сара усҟан сыԥшқан, 	В последний раз, когда Длинноногий говорил о мире, я был мальчиком. 
гәԥҩык ҳаҭыр зқуз Ашоҭландцәа ихарҵеит иара иажәақәа, 	Многие шотландские дворяне, которые не желали быть рабами 
насгьы иареи уи аамышьҭахь ижьаны иҭеигалт ... 	были завлечены в ловушку под флагом перемирия, 
аца рыззагь икнеиҳаит. 	в амбар, где он повесил всех. 
Сара сыҷқәынан, аха сгәаҽы инхеит иара ишеилыкаауа аҭынчра. 	Я был очень молод, но я запомнил понятие Длинноногого о мире. 
Сара издыруеит шәара шәгәырҩуан, 	Я понимаю, что вы пережили. 
издыруеит шәара бзиа ижәбуа. 	Я знаю о вашей женщине. 
Бзиа ижәбуа лакәым, 	Она была моей женой. 
аха ҳара маӡала ҳаибагеит, 	Мы поженились тайно, 
исҭахымыз деимаҳкыр Англиатәи ҭауади сареи. 	потому что я не хотел делить ее с английским лордом. 
Дара дыршьит лара, ирҭахын сара сыргарц. 	Они убили ее, чтобы добраться до меня. 
Уаанӡа сара уи аӡбахә сҳәаӡомызт, 	Я никогда не говорил об этом 
исыздвруам уи сара шәара изшәасҳәа 	и не знаю почему рассказываю вам. 
иҟалап избоит лара лымч шәара шәҟаны, 	Разве что я вижу ее силу в вас. 
шәара кралс шәаныҟалалак, 	Однажды вы станете королевой, 
шәара шәыла аашәыртыроуп. 	и вы должны открыть глаза. 
Акрал иашәҳәа, 	Скажите вашему королю, 
Уилиам Уалас тәыс дҟалаӡом. 	что он не будет править Уильямом Уоллесом 
Сара сыԥсы ахьынӡаҭоу дарбанзаалак Шоҭландуаҩык дзыҟалом тәыс. 	и ни одним шотландцем, пока я жив. 
Сыҷқәын иԥҳәыс гәакьа дхынҳәит ԥыршәа лымамкәа агәымбылџьбарцәа рыҟнытә. 	Верная жена моего сына возвращается невредимая от этого дикаря. 
- Иара идикылама аҵарҭыша? - Мап, идымкылаӡеит. 	- Так он принял нашу взятку? - Нет, не принял. 
Нас иара дызгылоузеи? 	Тогда почему он остался? 
Сара сыԥшыхәҩцәа иаарыцҳоит ақәылара шыҟарымҵа. 	Мои разведчики сказали, что он не наступает. 
Иара дшәызԥшуп, Иорк аҟны. 	Он ждет вас в Йорке. 
Уажәазы сақәлаӡом иҳәеит иара. 	Он говорит, что не будет больше брать города, 
Шәара ишәызхозар ахаҵара иареи шәареи шәеиԥылара. 	если вы достаточно смелы, чтобы сразиться лицом к лицу. 
Ааи. 	Правда? 
Уелзтәи ахыци ахәмпалы аршәыҩцәа рҽыҵәахны 	У эльских лучников не заметит. 
ага рҽаҭаны ицароуп. 	Они обойдут его с флангов. 
Ҳара ҳар ихадоу амчрақәа Франциатә иӡхыҵоит абра, 	Основная сила наших армий из Франции высадится здесь, 
ҩадахьы Еденбра, 	к северу от Эдинбурга. 
Аирландцәа иадгылоит адамраҭашәарантә, абрааҵәҟа. 	Новобранцы из Ирландии подойдут с юго-запада 
Франциатәи ар. 	вот сюда. 
Уелзтәи ахыци ахәмпалы аршәцәа Аирландцәа 	У эльские лучники, французские войска, ирландские новобранцы. 
Иахьаҵәҟа идәықәрҵаргьы ицоит мчыбжьык аҽазыҟаҵара. 	Даже если отправить их сегодня потребуется неделя собрать их. 
Сара идәықәсҵеит дара, уаанӡа, уԥҳәыс ддәықәсҵаанӡа. 	Я отправил их до того, как послал твою жену. 
Иара убас ҳагызмалра маншәалахт, иҭабуп. 	Так что наша маленькая уловка сработала. Спасибо. 
Уажәазы ари акыдԥалара дазыԥшуп сара сцәырҵра, Иорк аҟны. 	И пока этот выскочка ждет моего прибытия в Йорке, 
ҳара ҳамч наӡоит Еденбра аҟынӡа, егьи ҳамч аанхоит ашьҭахь. 	мои войска прибыли в Эдинбург за его спиной. 
Убри Уаласи бареи шәанеизынха шәхала, 	Ты говорила с этим Уоллесом наедине? 
адәаҟны, 	Скажи... 
дзакәтә уаҩузеи иара? 	Что он за человек? 
Хымҩа змам ақәылаҩ. 	Безумный варвар. 
Акралра илаӡам шәара шәеиԥш. шәхаҵкы. 	Не королевской стати, как вы, мой господин. 
Уажәшьҭа шәгыжьыр ҟалоит шәара шәнапҟаҵамҭахь. 	Можешь вернуться к своей вышивке. 
Ибзиоуп шәхаҵкы! 	Повинуюсь, мой господин. 
Ҳәарада шәара иаажәгеит уашьҭахьтәи аҟәрышьқәа. 	Деньги ты, конечно же, привезла обратно. 
Мап. Сара ирысҭеит ахәыҷқәа, аибашьра аан ааха зауз. 	Нет. Я отдала их, чтобы уменьшить страдания детей от этой войны. 
Абри ауп иҟало аԥҳәыс данаушьҭлак. 	Вот что случается, когда посылаешь женщину. 
Саҭамзааит шәхацкы, 	Простите меня, сир. 
Сара изӡбит агәыҳалалра аалырԥшоит, шәара шәаҳаракыра. 	Я сочла, что такая щедрость покажет ваше величие вашим подданным. 
Сара саҳаракыра, 	Мое величие 
иаанырԥшоит Уалас даныхынҳәлак иара ишатландиахь, 	они увидят ясно, когда Уоллес вернется в Шотландию 
ирбганы иахкажьу. 	и найдет свою страну в пожарищах. 
Уилиам, 	Уильям. 
иааигәахоит аҽыҩцәа. Уамашәа иубаша, 	Всадники едут. 
аҳкәажә длыцуп лгәылхазыршҭуа. 	Личный эскорт принцессы. 
Ааи. 	Да. 
Уара ириуҭеит анырра. 	Ты произвел впечатление. 
- Ааи. - Аха уара ақьалаҿы ирацәаны уҟаӡамызт. 	- Да. - Но ты же был в шатре не так долго. 
- Аҭыԥҳа - Саҳкәажә лыҟнынтә ажәанҵа. - Иҭабуп. 	Послание от моей госпожи. 
Ари иашоуп. Англыз ӷбақәа иааигәахоит мраҭашәарахьынтә. 	Это правда. Английские корабли приближаются с юга. 
Сара акгьы сыздыруам Уелзуаа рыӡбахәала, аха Аирландцәа уажәшьҭа иӡхыҵит. 	Я ничего не знаю о уеллийцах, но ирландцы уже высадились. 
Сыбла иамбакәа исызхамҵеит. 	Я не поверил, пока не увидел своими глазами. 
Изрыцхыраауазеи Аирландцәа, Англиаа? 	Какого черта ирландцы будут сражаться за англичан? 
Урҭ рзыҳәа агәрҩа шәҽашәмырган. Сара ишәасымҳәазеи, 	Я бы не беспокоился о них. Разве я не говорил? 
ари сара сыдгьыл бжьахоуп. 	Это же мой остров. 
Ҳеимиш. Уҽыжәла Еденбраҟа еидкыл абыргцәа рхеилак, ирццакны. 	Хэмиш, скачи в Эдинбург и собирай совет. Прикажи им. 
Ибзиоуп. Уҵҟьа. 	Ясно. 
- са истәуп уҳәама? - Сыдгьыл бжьахоуп, сыдгьыл бжьахоуп. 	- Твой остров? - Мой остров! 
- Иинараӡам. - Сшәыҳәоит шәара шәыххь згеит. 	- Нам нужно договориться. - Пожалуйста, джентльмены. 
Уара унашоуп. 	Господа, Крейг прав. 
Уажәазы ҳара иҳамоуп ҭагылазаашьак. Ҳара иаҳҭахӡам Еденбра зынӡа адунеи ианырхыр. 	Сейчас единственный выбор для нас - переговоры. 
Шәхацкы аԥсшьара амбеижьҭеи. Акрааҵуеит, 	Моя армия прошла маршем больше дней, чем я могу вспомнить, 
ҳаргьы аҵыхәтәанынӡа ҳазыҟаҵаӡам, иара убасгьы ишәасҳәоит иашаны. 	и нам все еще нужно подготовиться, так что я скажу коротко. 
Ҳара иаҳҭахуп ишәымоу ар зегьы, 	Нам нужен каждый солдат, которого вы можете призвать. 
насгьы шәыхьчаҩцәеи, иара шәара шәхаҭакәгьы. 	Ваша личная свита, даже вы сами. 
Ҳәарада ирццактәуп. 	И нужны немедленно. 
Арысҟатәи амчқәа змоу ҳара иаҳҽагыло, иԥшаатәуп егьырҭ ахыцәгарақәа? 	Но против нас целое войско. Может есть другие возможности? 
Ахықәгарақәа, 	Другие возможности? 
аханатә ар наҟ аиагара еҳа еиӷзар, аибашьра адәаҿы, 	Вы не хотите хотя бы вывести ваших людей на поле боя 
нас иашәҭаххар Едуард иҟнытә иреџӷьу. 	и договориться с Длинноногим перед тем, как поджать хвост 
- Аилаӡара нас ҳҽыцәахны ҳақәҵны ҳцаанӡа. - Аамсҭа Уилиам 	- и сбежать. - Сэр Уильям... 
- ҳара ҳзиааиӡом. - Ҳара иҳалшоит, 	- Мы не сможем поразить их. - Сможем. 
- аамсҭа Уилиам. - насгьы ҳаиаауеит. 	- Сэр Уильям. - И мы победим. 
Ихаан ҳара ҳамаиааизи? 	Мы победили у Стерлинга, а вы все еще колеблитесь. 
ҳара иаҳгахьан Иорк, аха шәара шәҳадгалаӡамызт 	Мы победили у Йорка, и вы не поддерживаете нас. 
шәҳашьҭаланы шәмаалар сара ишәыхьӡыстәоит ашәыргәндақәа. 	Если вы не станете с нами сейчас, я скажу, что вы трусы. 
Шәара шәШотландцәамзар, 	Если вы шотландцы, 
сара иԥхасшьоит. Шәара шәШотландцәоуп ҳәа шәзыҳәара. 	то мне стыдно, что я один из вас. 
Аамсҭа Уилиам! Ҳара ҳзеицәажәару уареи сареи ҳамацара? 	Пожалуйста, сэр Уильям, поговорим наедине. 
Сшәыҳәоит шәара. 	Умоляю. 
Уара утәқәа ирацәаны инарыгӡахьеит. 	Вы достигли большего, чем кто-либо мог мечтать, 
Аха уи агәмшәара иаҵанакӡом, аха уи иаанагаӡом агәеибафара. 	но сражаться с неравными силами - это безумие, а не отвага. 
Ари еиҳауп агәеибафара ацкыс, 	Это больше чем безумие. 
шәсыцхраа, 	Помоги мне. 
анцәа иҟнытә, 	Во имя Христа, помогите себе. 
уажә ари ҳара ҳзы имариоуп. 	Сейчас наш шанс. Сейчас. 
Ҳаидгылар ҳара ҳаиааиуеит, 	Если мы объединимся, мы победим. 
ҳаиааир иҳауоит ахаан иаҳмоуцыз 	Если победим, то обретем то, о чем никто из нас и не мечтал. 
ҳхатәы тәыла, 	Собственную страну. 
шәара зинла шәаԥхьагылаҩцәоуп, шәара ишәымоуп амчра сара уи збоит. 	И ты законный вождь, в тебе есть сила, я вижу это. 
Ҳаидышәкыл ҳара, 	Объедини нас. 
еидышәкыл аклан. 	Объедини нас. Объедини кланы. 
Ааи. 	- Хорошо. - Так. 
Ари ҟазышьа амаӡам. 	Это не выход. 
Уара ухала иумҳәеи, аҭауадцәа Уалас идгылом ҳәа, 	Ты же сам сказал, что знать не поддержит Уоллеса. 
ҵакыс иамоузеи иаҵахаз иганахь аиасра? 	Чем нам поможет то, что мы встанем на сторону, которая будет разбита?
Сара иара исҭеит ажәа. 	Я пообещал ему. 
Издыруеит ари цәгьоуп, аҟазаара ахадараҟны, 	Я знаю это нелегко быть вождем. 
сыҷқәын, 	Сын мой. 
сԥа. 	Сын. 
уааҳәы, 	Посмотри на меня. 
сара сзыҟалом кралс, 	Я не могу быть королем. 
уара, уоуп изылшуа Шотландиа анапхгара. 	Лишь ты можешь править Шотландией. 
Уара иҟауҵароуп сара ишысҳәо, 	Но делай то, что я тебе скажу. 
сара сакәӡам. Уаргьы уакәӡам, 	Не ради меня, не ради себя, 
уара утәыла азоуп. 	а ради своей страны. 
Фалкирк. 	Фолкирк 
Ачқәынцәа амҩа ҳашәҭ, 	Дорогу, ребята, дорогу. 
амҩа ҳашәҭ. Иҟалозар ҳаушәышьҭ, амҩа... 	Дорогу. 
- Брус дыҟаӡам, рыцҳароуп. - Иара дҟалоит. 	- Брюс не придет, Уильям. - Придет. 
Морнеи Локландеи иааит. 	Морней и Лохлен пришли. 
Брусгьы дҟалоит. 	Значит и Брюс придет. 
Изакузи ари ахлымӡаах? 	Милое сборище. 
Шәара шәазыразума? 	Согласен? 
- Хыци хәымпалы аршәыҩцәа мазеуп. - Уажәазы иаҭахӡам. 	- Лучники готовы, сир. - Не лучники. 
Аԥшыхыҩцәа ирҳәоит 	Мои разведчики сообщают, 
ахыци хәымпалы аршәыҩцәа ихароуп ацәшәара ҟамлар ҟалоит. 	что их лучники за много миль отсюда и не представляют угрозы. 
Урҭ рхыцқәа аҟәрышь иаԥсоуп. Ишәшьҭы Аерландцәа, аԥсцәа акы иаԥсам. 	Стрелы стоят денег. Используйте ирландцев. Мертвецы ничего не стоят. 
Нас ишәәшьҭы ашьаҟауааи, аҽыуаҩцәеи, акавалериа. 	И посылайте пехоту и кавалерию. 
Ашьаҟауаа, ашьаҟауаа, 	Пехота. 
аҽыуаҩцәа, аҽыуаҩцәа, 	Кавалерия. 
аҽыуаҩцәа ԥхьаҟа, ԥхьаҟа, 	Наступаем. 
сара издыруан, сара издыруан шәара шәшаауаз. 	Рад видеть тебя, дружище. 
Аирландцәа! 	Ирландцы. 
Сгәырӷьоит шәара шәахҳацу. Шәааԥши. 	Рад, что вы с нами. Смотри. 
Морне, Локланд 	Морней? Лохлен? 
Морне исҭеит иара убри аҟара, 	Я дал Морнею вдвое больше земель в Шотландии 
адгьылқәа Англиа. 	и такие же поместья в Англии. 
Локланд даԥсан ирацәаны. 	Лохлен предал за меньшую цену. 
Ахыци ахәымпалы ала ахысыҩцәа! 	Лучники. 
Саҭамзааит шәхацкы иаргәаҟоит ҳара ҳашьаҟауаа. 	Прошу прощения, сир. Мы же не будем стрелять по своим войскам. 
Ааи. 	Будем. 
Аха игәаҟоит ҳаӷацәа. Ҳара иҳамоуп хатәгәаԥхаратәи аруаа, 	Но мы будем стрелять и по их войскам тоже. У нас есть резервы. 
ԥхьаҟа! 	Атакуем. 
Ахыци хәымпала ахысыҩцәа, Ахыци хәымпала ахысыҩцәа, Ахыци хәымпала ахысыҩцәа … 	Лучники. 
иаамҭоуп ацхыраарахь ашьҭра. 	Посылайте подкрепление. 
Зегьы ԥхьаҟа! 	Посылайте остальных. 
Даажәг Уалас, иԥсы ҭаны. 	Приведите мне Уоллеса. Живым, если возможно, 
Мап, усгьы иҟалоит. 	но мертвый тоже сгодится. 
Шәшаалгалак еиԥш иаашәыцҳа. Шәааи ҳақәҵп. 	И пошлите новости о нашей победе. Мы удаляемся. 
Дышәыхьча акрал. 	Охраняйте короля. 
Угыл .. 	Вставай. 
угыл .. угыл .. 	Вставай. 
- дықәга арантә. - Анцәа ду. 	Забери его отсюда. 
Уца … Уажәыҵәҟьа. 	Вперед. 
Сара сыԥсоит. 	Я умираю. 
Сааныжь схала. 	Оставь меня. 
Мап. 	Нет. 
Уара уԥсы ҭазаауеит. 	Ты будешь жить. 
Сара акыр ҵуеит сыԥсы ҭоижьҭеи, схы сақәиҭын, 	Я прожил достаточно, чтобы жить свободно. 
сара сгәы иаахоит 	Я горд, 
уара узлаҟоу ала. 	что увидел кем ты стал. 
Сара разҟы змоу уаҩуп. 	Я счастлив. 
Абаара саҽуп сыԥсы зҭоу, аха уара ухауҽы еиқәшьшьуп сара стәаҵкыс. 	Я почти разлагаюсь, 
Сыҷкәын. 	Сынок. 
Абра анапхгара аҭаразы ҳара иҳамазароуп Англиеи ҳареи аимадара. 	Мы должны заключить союз с англичанами, чтобы править здесь. 
Уара убри наугӡеит, 	Ты достиг этого. 
уара иухьчеит уҭаҳцәа, еихауҳаит адгьылқәа. 	Ты спас свою семью и расширил свои земли. 
Уара иоуеит амчра Шотландиа, 	Со временем ты соберешь всю власть в Шотландии. 
амчра, 	Земли. 
атитулқәа, ауаа, 	Титулы. Людей. 
адгьылқәа, акгьы. 	Власть. Ничего. 
- Акгьы? - Акгьы ыҟаӡам. 	- Ничего? - У меня нет ничего. 
Сара сзыҳәа еибашьуеит, сыдгьыл иқәсымцарц 	Люди сражаются за меня потому что иначе я прогоню их со своей земли, 
амла иакны имԥсырц. 	и я заморю голодом их жен и детей. 
Дара зегьы 	Эти люди, 
ашьа казҭәаз Фалқак аҟны, 	которые залили землю кровью в Фолкерке. 
иқәԥон Уалас изыҳәа, 	Они сражались за Уильяма Уоллеса, 
иара дықәԥон ахаан сара исымамыз азы. 	а он сражается за то, чего у меня никогда не было 
Сара имсхит убри, 	И я отнял это у него, когда предал его. 
ибла ихызбаауан убри зегьы. 	Я прочел это у него на лице на поле боя. 
Ари хлымӡаахроуп. 	И это терзает мою душу. 
Ауаа зегьы ԥсадгьыл ҭицәоуп. Аҽар зегьы ус оуп ишыҟоу. 	Все предают. Все теряют сердце. 
Агәра згар сҭахуп. 	Я не хочу терять сердце. 
Исҭахуп агәра згар баша 	Я хочу верить, 
иара еиԥш. 	как он. 
уажәшьҭа издыруеит сыздгылуа аган 	Я никогда больше не встану на неверную сторону. 
Мап. 	Нет. 
аамсҭа Крек, ари иашоума Иорк иахьыз? 	Лорд Крейг, это правда про Монрея? 
Ааи, Уалас дишьиҭ ашьҭаларҭа ауаҭах аҟны. 	Да. Уоллес ворвался в его спальню и убил его. 
Уажәшьҭа иара иоуеит ирацәаны алас-ҩасра. 	Он теперь больше помеха, чем когда-либо. 
Дазусҭахода ишьҭанеиуа? 	И не известно кто станет следующим. 
Иҟалап шәара? 	Может ты. 
Иҟалап сара. 	Может и я. 
Уи хадарам. 	Это не важно. 
- Хәмаррада Роберт. - Саргьы. 	- Я серьезно, Роберт. - Я тоже. 
Аҩсҭаа. 	Господи. Черт. 
Абааш еимыжәда. 	Обыскать все. 
Локлан. 	Лохлен. 
Уилиам Уалас иишьит 50-ҩык. 	Уильям Уоллес убил 50 человек. 
50-ҩык зныкала . 	Один целых 50. 
100-ҩык. Иаҳәала дара дрылсны дцеит. 	100 человек. Своим мечом. Он прошел через них, 
Моисеи иеԥш амшын ҟаԥшь ала. 	как Моисей через Красное море. 
Иара иизкны ирыҩоит алегендақәа 	Легенды про него ширятся. 
Аҭагылазаашьа еицәоуп уажә 	Будет хуже, чем раньше. 
аасҭа Еидикалоит хатәгәаԥхаралатәи ар Шотландиа ақалақьқәа зегь рыҟнынтә. 	Он собирает новых добровольцев в каждом шотландском городе. 
Нас иара ианеизигалак. 	Когда он соберет свое войско... 
Дара уасақоуп, баша иахьынӡахҭоу уасақоуп. 	Они бараны. Просто бараны. 
Дара еиԥхьттоит ахьча дрымамзар. 	Их легко рассеять, если мы уберем пастуха. 
Ибзиоуп. 	Очень хорошо. 
Уара иалуԥшар иреиӷьу ашьцәа, нас имҩаԥыугап аиԥылара. 	Собери своих лучших убийц и назначь встречу. 
Шәхаҵкы! Уалас ацәҟьа аҟны 	Мой господин, про Уоллеса говорят, 
даара ихы бзианы ибоит. 	что он нюхом чует любую западню. 
Ус анокәха исеиҳәаз аамсҭа Ҳамылҭен аиаша, 	Если то, что лорд Гамильтон сказал неверно, 
нас ҳагәра игоит ԥхьаҟатәи ҳакрал. 	ему по душе наша будущая королева, и он поверит ей. 
Ҳара ддәықәҳцап ажәабжьқәа лыҭаны лара дшаауа аҭынчразы. 	Так что мы отправим ее к нему и скажем, что она пришла с миром. 
Шәхаҵкы, аҳкәажә дбаандаҩртәыр ҟалоит. 	Но принцессу могут взять в заложники, 
Лыԥсҭазаара ашәарҭа иҭагылоуп. 	или ее жизнь может быть подвергнута опасности. 
Аха сыҷкәын ҵҩа амамкәа дылзыгәырҩоит. 	Мой сын пострадает от этого, 
Аха лара дыршьыр 	но по правде, если она будет убита, то окажется, 
Франциа крылс дҟалоит 	что будущий король Франции 
ҳара даҳҩызаны, Шоҭландиа аҿаԥхьа. 	станет полезным союзником против шотландцев. 
Иубо, 	Видите, 
акрал дацәцоит иарбанзаалак аҭагылазаашьа. 	королю приходится искать выгоду в любой ситуации. 
Ари Уилиам Уалас, 	Это Уильям Уоллес, точно. 
илабашьа адгьыл иҵаирст. 	И он оставил свой меч. 
Шәыҽшәырхҩа. Аҳкәажә. 	Моя госпожа. 
Сара исауит шәысалам шәҟәы. 	Я получил ваше сообщение. 
Шәара ҩынтә сгәы сҽанышәҵахьеит ашәарҭара сара сзы, 	Второй раз вы предупреждаете меня об опасности. 
иауеи? 	Почему? 
Ҽааны иаауа амзазы ашьхарахь идәықәрҵоит аидара ҿыц, 	В следующем месяце с севера придет следующая поставка припасов. 
уа иҟалоит афатә, абџьар, аидара. 	Еда и оружие. Они... 
Иаанкыл. 	Довольно. 
Избан шәызрыцхыраауа? 	Почему ты помогаешь мне? 
Избан сара? 	Почему ты помогаешь мне? 
Абыржә шәахихәаԥшуа азы. 	Из-за того, как ты смотришь на меня сейчас. 
Ҳара уажәшьҭа ианаҳцәыӡ агәыӷра, 	Когда мы подумали, что вся надежда утрачена, 
ицәырҵт ҳара ҳаҭауадтә еиқәрхаҩцәа. 	прибыли наши доблестные спасители. 
Иҟалоит иамшәхыр ааҵәақәа. 	Снимите их капюшоны. 
Аамсҭа Уилиам, ҳара ҳаҳәоит аиԥылара. 	Сэр Уильям, мы пришли искать встречи. 
Ҵакыс иамоуи? 	В чем дело? 
Шәара шәеиныкәт ашьапҩзы ииашара азы, 	Вы поклялись в верности Длинноногому. 
амцҳәаҩ изыҳәа уи иҭацәу шьҭыбжьуп. 	Клятва лжецу вовсе не клятва. 
Ҳара иаҳтахуп ишәзааҳгар аиашазы ақәра. 	Каждый наш человек готов присягнуть в верности тебе. 
Иҟарҵааит атаҳмадацәа рхеилак зегьы ирбо ираҳәуа, 	Так пусть совет публично присягнет. 
иаҳзыҟаҵом, дара ихарҵом шәара шәыԥсы шҭоу, 	Мы не можем. Многие не верят, что ты жив. 
егьырт иацәшәоит Морне илахьынҵа. 	Другие считают, что ты отплатишь им, как Морнею. 
Ҳаиқәшәоит Еденбраҿы 	Так что мы приглашаем тебя в Эдинбург. 
2-мш рышьҭахь. 	Приезжай через два дня. Объяви, что прощаешь нас, 
ҳара ҳаидгылоит шәааигәа сигәа, 	и мы встанем за тебя. 
- нас Шотландиа иҟалоит акакәны. - акакәны. 	- Шотландия будет едина. - Едина? 
- шәара ҳа-ҳзакәнгьы, шәа-шәзакәнгьы? - мап. 	- То есть мы и вы. - Нет. 
Сара абри азоуп. 	То есть вот это. 
Роберт Брус ихәдықәҵара. 	Это обещание Роберта Брюса. 
Уара иумдыруеи, ари цәҟьоуп. 	Ты же знаешь, что это ловушка. Скажи ему. 
Иара ииаҳә. Брус иҭаххар уара уишьуан Фалкерк аҿы. 	Если бы Брюс хотел убить тебя, он бы сделал это у Фолкерка. 
Ааи. 	Да. 
Сара издыруеит, сара избеит, 	Я знаю. Я видел. 
ибзиоуп, иара делкаауп. Егьырҭ шԥаҟоу? 	Хорошо, а кроме него как остальные? 
Рҽеизганы агызмалцәа, абзамыҟәақәа, дара аҽакала изеинаалом, ари цәҟьароуп. Убла аарты. 	Подлые ублюдки, они на все готовы. Это ловушка. Ты что, ослеп? 
Усзыӡырҩы, 	Посмотри на нас. 
иаҳҭахуп аҭауадцәа ҳадгылара аҳауа аиԥш. 	Нам нужно попробовать, мы не справимся сами. 
ҳәӷра заҵә ҳажәлар зегь, 	Единственная надежда у нас - объединиться с дворянами. 
рзыҳәа ҳхы, Ианаҳмырхәа имарианы, 	Знаешь что случится в противном случае? 
нас изакәи? 	Что? 
Акгьы, 	Ничего. 
- сара исҭахӡам сҟалар сџьабаацәгьаҩны, - саргьы. 	- Я не хочу быть мучеником. - Я тоже. 
Исҭахуп аԥсҭазаара, 	Я хочу жить. 
исымазарц аҩны, ахәыҷқәа нас аҭынчра. 	Я хочу иметь дом, детей и мир. 
- Ииашаны? - Аиаша. 	- Правда? - Да. 
Сара убри азыҳәан анцәа сиҳәоит, аха ҭынчрада, ари зегьы башоуп. 	Я просил этого у Господа, но все ни к чему, если у тебя нет свободы. 
- Ари баша гәыӷроуп. - Агәыӷра? Хымԥада. 	- Это просто мечта, Уильям. - Мечта? Просто... 
Нас иҟаҳҵо закәи абри аамҭа зегьы. 	А что мы тогда делали все это время? 
Мчыла иаҳа ҟарҵар ҳҭахуп. 	Мы ведь жили этой мечтой. 
Амала ахақәиҭра акгьы иаҵанакӡом. Уара уазхәыци Марон. 	Ты мечтаешь не о свободе. А о Маррон. 
Аԥыжәара укәуп, игәы иаанагоит лара улбоит ҳәа. 	Ты хочешь быть героем, потому что думаешь, что она тебя видит. 
Мап, сара ус схәыцӡом, сара издыруеит уи. 	Я не думаю, что она меня видит. Я знаю наверняка. 
Уаргьы, уаб уибоит. 	И твой отец тоже видит тебя. 
Анцәа ду. 	Господи. 
Угыл. Суццома? 	Пойти с тобой? 
Мап. Схала сцоит. 	Нет, я пойду сам. 
- Ҳаибабоит. - Ааи. 	- Увидимся позже. - Хорошо. 
Сгәыӷоит азԥшра маҷны илзынхеит. 	Надеюсь, все же раньше, а не позже. 
- Иара дааӡом. - даауеит. 	- Он не приедет. - Приедет. 
Сара агәра сызгом. 	Я знаю, приедет. 
Шәхаҵкы, иара дааигәахоит. 	Мой господин, он приближается. 
Мап. 	Нет! 
Уаԥырхагамхан Роберт. 	Не вмешивайся, Роберт. 
Брус дмыргәаҟтәуп. 	Прочь! 
Иҳаман аиқәшаҳаҭра. 	Мы договаривались, что Брюс будет невредим. 
Саб. 	Отец! 
Уара. Уара алахша. 	Ты, гнилой ублюдок! 
Иауеи? Иауеи? 	Почему? 
Ашьапҩзы иара даара диԥырхаган, 	Длинноногому нужен Уоллес. 
ҳара ҳаамсҭцәа ҳԥырхаган, 	И нашей знати тоже. 
ари гәнаҳароуп агәыргьын азы. 	Такова была цена твоей короны. 
Уԥсхаԥсы. 	Умри! 
Уԥсха-ԥсааит уара. 	Я хочу, чтобы ты умер. 
Сара ирласны сыԥсоит. 	Я умру довольно скоро. 
- Агәырҩа уамган, уара укралхоит. - Уара уҟнытә акгьы сҭахӡам. 	- А ты станешь королем. - Не нужно мне от тебя ничего. 
Уара уаҩӡам, 	Ты не мужчина. 
уара саб уакәӡам. 	И ты не отец мне. 
Уара са сыҷкәын уоуп. 	Ты мой сын, 
Енагь иудыруан уара са схы иҭоу, 	и ты всегда знал, что я думаю. 
- уара сыужьеит. - Уара уоуп зхы зжьаз, 	- Ты обманул меня. - Ты позволил обмануть себя. 
аха гәаныла иудыруа иҟалаша. 	В твоем сердце ты всегда знал, что должно произойти здесь. 
Иааԥцәаны уара еилукааит ацәымӷра. 	И вот, наконец, ты знаешь что значит ненавидеть. 
Уажәшьҭа уара уазыхҩоуп акралра. 	Теперь ты готов быть королем. 
Сара сцәымӷра ԥсоут уара иуцны. 	Моя ненависть умрет с тобой. 
Уилиам Уалас! Шәара ахара шәыдуп аҳәынҭқарра аԥсахразы. 	Уильям Уоллес, вы обвиняетесь в государственной измене. 
- Зҽаԥхьада? - Шәыкрал 	- Кому? - Вашему королю. 
ишәҳәар ишәылшозеи? 	У вас есть что сказать? 
Исҳәар исылшоит ахааназгьы. 	Никогда за всю свою жизнь 
Сара сымқәӡит аиашазы. 	я не присягал ему в верности. 
Уи агьыурым. Иара шәара шәыкрал иоуп. 	Не имеет значения. Он ваш король. 
Шәахьхәыр ишәоуеит ирласны аԥсра. 	Сознайтесь в этом и получите скорую смерть. 
Мап анакәха шәара шәахысроуп аҽрыцқьара ахьаа. 	А если будете отрицать, вас придется очистить болью. 
Нас ишԥажәуа, шәахьхәуама? 	Вы признаетесь? 
Шәара шәҽы шәықәшаҳаҭхома? 	Вы признаетесь? 
иаанагоит аҿрыцқьара шәара ишәоуеит уаҵәы ашьыжь. 	Ну что же, утром вы получите очищение. 
- Шәыҳаракыра шәхаҵкы! - Сара абандаҩы иахь, 	- Ваше Высочество. - Я к заключенному. 
- акрал иҳәеит аӡәгьы наҳмышьҭырц. - Акрал дыԥсоит мызкы ашьҭахь, иҷкәын дбашоуп. 	- Король приказал... - Король скоро умрет, а его сын слаб. 
Уара утәала дарбан иныҟәзго? 	Кто по вашему будет править этим королевством? 
Иаарҭы ашә. 	Откройте дверь. 
Шәара шәыҳаракыра! 	Ваше Высочество. 
Угыл ацәыршәага. Уаанҽас, 	Вставай, мразь! А ну, встать! 
ҳааныжь ҳара. 	Довольно. Ступайте. 
Сара иуасҳәт ҳааныжь. 	Я сказала ступайте. 
Аҳкәажә! 	Моя госпожа. 
Ухаҵкы! 	Сэр, 
Сшәыҳәоит шәара, 	я пришла умолять вас 
шәахьхәу, шәқәы акрал игәрагаразы, 	признаться во всем и поклясться в верности королю, 
нас иара шәишаҭар ҟалоит. 	чтобы он проявил милосердие. 
Сара стәыла ишаҭару? 	Проявит ли он милосердие к моей стране? 
Ашаҭара еиҳауп аԥсра ацкьыс. 	Милосердие - это быстрая смерть, 
Абааш аԥсҭазаара иамоуп аамҭанык, 	а может и заточение в башне. 
ихадоу шәара шәыԥсы ҭазароуп. 	А тем временем кто знает, что может случиться. 
Иара иҽаԥхьа 	Если б вы могли жить... 
сара иузымч ҭоуба шьҭасҵар, 	Если я поклянусь ему, 
нас сыҩнуҵҟа зегьы ԥсоит, 	тогда погибнет все, чем я являюсь. 
Шәара шәыԥсыр хлымӡахроуп. 	Вы умрете. Это будет ужасно. 
Зегь ԥсоит, 	Все умирают. 
аха иҵабыргны зегь зынхом. 	Но не все живут по-настоящему. 
Ижәжәы абри, 	Выпейте. 
ахьаа артәарц. 	Это усмирит вашу боль. 
Мап. Ари сыхдырра хнаҿоит. 	Нет, это замутнит мой разум. 
Сара сҭанагалоит ацәанырра, 	А он мне нужен. 
сара сыхдырра цқьазароуп, 	Если я потеряю сознание или закричу, 
мамзар ашьапҩзы сыхирбгалоит. 	тогда Длинноногий победит меня. 
Иузымчҳуа ахшыҩ ҵак, шәара шәдырҳәацәалоит. 	Я не вынесу мысль о ваше пытке. 
Абри жәжәы. 	Примите это. 
Ибзиоуп. 	Хорошо. 
Сара сшәыҳәоит, 	Я пришла 
сшәыҳәоит дышәшаҭарц Уилиам Уалас. 	умолять жизни Уильяма Уоллеса. 
Шәара лабҽаба иара иахь шәхы ӡырыжәгом. 	А ты весьма очарована им, да? 
Сара пату иқәсҵоит иара. 	Я уважаю его. 
Шәаарыԥхьа иара пату қәҵара хатәы жәлар. 	Он был достойным врагом. 
Акрал дуӡӡа! Иаашәырԥшы агәшаҭара, сшәыҳәоит шәара. 	Прояви милосердие, и ты получишь уважение собственных людей. 
Иара абыржәыҵәҟьа. 	Даже сейчас 
Шәара ишәзаарԥшӡом агәшаҭара. 	ты не способен на милосердие. 
Нас шәара? 	И ты. 
Шәара шәзыҳәан ажәа еилкааӡам убасҵәҟьа, абзиабара еиԥш. 	Тебе неведомо слово любовь. 
саб иҿы акаанӡа, 	Перед тем, как он потерял дар речи, 
иара иҳәеит дара дшырыжьжьо 	он сказал мне последнее желание, что он живет лишь ради того, 
Уалас иԥсразы. 	чтобы узнать, что Уоллес мертв. 
Ижәбо, 	Видишь? 
зегь рахь иаабоит аԥсра. 	Смерть приходит ко всем. 
Аха иара аиаанӡа, иара анааилак, 	Но перед тем, как она придет к тебе, 
ижәдыруаз шәара 	знай, 
шәымҭашьҭа нҵәоит шәара шәыла. 	что твоя кровь умрет с тобой. 
Сара дныҟәызгоит ахәыҷы мгәарҭа, иахьыҟам шәара шәшьа. 	В моем чреве растет дитя не твоей крови. 
Шәара шәыҷкәын дзаанхом акраамҭа агәыргьынаҿ, шәара шәныс. 	Твой сын не долго будет на троне. Клянусь. 
Сара сшәоит. 	Мне так страшно. 
Амч сыҭа. 	Дай мне силы 
сыԥароуп хьӡыла-ԥшала. 	умереть достойно. 
Абаар иара. Абаар иара. Анцәа. 	Вот он, смотрите. 
Иааит акааимет ақәшәара атәыла аҭиразы. 	Вот ужасная цена измены. 
Ма ушьамхнышьгал, 	Упади на колени сейчас. 
ирылаҳәа уара акрал инапаҵаҟа уҟоуп ҳәа. 	Объяви себя верным подданным короля 
Уиыҳәала иара игәшаҭаразы. 	и умоляй о милосердии. 
Нас дуоуеит иара. 	И ты получишь его. 
Ашаха. 	Веревку. 
Усыцхраа ашьҭыхраҿ. 	Поднимите его. 
Шәиха иара. 	Тяните. 
Абас. 	Вот так. 
Деиҵышәхла. 	Вытягивайте. 
Иубама, ааа? 	Что, приятно? 
Угыл ушьамхнышьгыланы. 	Встань на колени. 
Уагәӡы акрал дыргасахьа сара скәымжәаҿы, 	Поцелуй королевский герб на моем плаще. 
нас уара угәаҟрақәа нҵәоит. 	И больше не будет боли. 
Шәгәашәҽаныл! 	На дыбу его. 
Иазхома? 	Довольно? 
Ари зегьы иҟалоит инҵәар, 	Все может окончиться 
абыржәыҵәҟьа. 	прямо сейчас. 
Аҭынчра, 	Покой. 
ақьафура. 	Блаженство. 
Баша иҳәа. 	Просто скажи это. 
Амала ҿҭы. 	Выкрикни. 
Ашаҭара. 	"Пощады". 
Ашаҭара. 	Пощады. 
Ашаҭара. Ашаҭара. Ашаҭара. 	Пощады. 
Уҳәҳәа. 	Выкрикни. 
Баша иҳәа. Ашаҭара. 	Просто скажи "Пощады". 
- иҳәа Ашаҭара. Иҳәа. - Иҳәа ари. 	- Пощады, Уильям, пощады. - Господи, ну скажи же. 
Ацәгьаҟаҵаҩ иҭахуп ак ҳаиҳәар. 	У зник желает сказать слово. 
Ахақәиҭра-а-а-а. 	Свобода! 
Ихы нхырҵәа ашьҭахь 	После обезглавливания 
ихәамц ԥҟаны хәҭа-хәҭала ишьҭарҵеит. 	тело Уильяма Уоллеса было четвертовано. 
Ихы иқәдыргылт Лондонтәи ацҳаҿы, 	Голова была выставлена на лондонском мосту. 
иара инаԥқәеи ишьапқәеи дәықәҵан аԥшьнҵәамҭақәа Британиахь, 	Его руки и ноги были отправлены в разные стороны Британии, 
агәҽанҵара еиԥш. 	как предостережение. 
аха алҵшәа ашьапҩзы игәы ишаанагоз изыҟамлеит. 	Но результат был вовсе не тот, на который рассчитывал Длинноногий. 
Нас сара Роберт Брус, 	И я, Роберт Брюс, 
сааҭгылт сыр сыманы идсырдырырц сара спатуқҵара Англиатәи акра лир ахь, 	выступил, чтобы принести присягу армиям английского короля 
нас исыдысқыларц иара идгылара сара сгәыргьын ахь. 	и получить согласие на мою коронацию. 
Агәра сымоуп сара ишыуӡәӡәаз ҳәа уара уашьҭахь, 	Я надеюсь ты подмыл зад сегодня утром. 
уажәы дагәӡраны дыҟоуп акрал. 	Сейчас его будет целовать король. 
Ҳцароуп. Аҵыхә ԥаҳҵәароуп. 	Поехали. Покончим с этим. 
Уаангыл. 	Стой. 
Шәара икашәҭәуан ашьа Уаласеи шәареи. 	Вы сражались с Уоллесом. 
Уажәшьҭа икашәҭәа ашьа сара сыла. 	Теперь сражайтесь со мной. 
Уалас. Уалас. Уалас. 	Уоллес! 
1314 шықәса қьырса иира аҟнытә, 	В год Господа нашего, 1314-й, 
Шотландиа аԥсадгьыл-бзиабаҩцәа, иҟан абжеиҵыраҩык амла ииагозгьы 	патриоты Шотландии, голодные, превосходимые числом, 
иаҽагылан иахьықәибахәаз Банекбан аҟны. 	вышли на поле Банекберна. 
Дара аҿагылоуп аибашьҩцәа, нас ажәеинраалаҩцәа реиԥш. 	Они сражались, словно поэты войны. 
Дара аҽагылан Ашотландцәа еибашьрыла 	Они сражались, как шотландцы 
иргеит дара рхақәиҭра. 	и завоевали свободу. 
