Абираҟ ҳаргылап	Установить флажок
Алхра	Выбрать
Иаарттәуп	Открыть
Иарктәуп	Закрыть
Актив азыура	Активировать
URL ҵабыргым, ҭагалашьа амам.	URL недействителен и не может быть загружен.
Ҿыц инаҳашьҭып	Отправить заново
Адокумент апринтер аҿгараан ма заантәи ақәыпшылараан аиҭакшьа амам.	Во время печати или предварительного просмотра документ не может быть изменён.
Адаҟьа, шәзхәаԥшырц ишәҭахәы аарԥшышьа амам, избанзар иамоу акомпрессиатә форма иашм ма иадгылом.	Страница, которую вы пытаетесь просмотреть, не может быть показана, так как она использует неверную или неподдерживаемую форму компрессии.
Шәылаԥш зхыжәгарц ишәҭаху адаҟьа аарԥшызар ҟалом, уи аартраҿы ишәарҭоу афаилхкы алоуп. Ауеб-саит зтәу шыҽимаданы ашәарара шыҟоу адырра ишәҭ.  	Страница, которую вы пытаетесь просмотреть, не может быть отображена, так как она содержит тип файла, небезопасный для открытия. Пожалуйста свяжитесь с владельцами веб-сайта и проинформируйте их об этой проблеме.
<еилкаам>	<неизвестно>
Ацраԥшьы аус аҳаруып	Запустить приложение
Аинформациа ыҟоуп асаит  %S ахархәаҩцәа ркомпиутерқәа рыжәларазы рхы иадырхәоит ҳәа. Ашәарҭаратә шәырхиагақәа ирыбзоураны уи аанкылоуп.	Имеется информация о том, что сайт %S используется для атак на компьютеры пользователей. В соответствии с вашими настройками безопасности он был заблокирован.
Адырраҭара ыҟоуп %S анапхыцәгьара иатәу авеб-саит ишатәу ала. Уи ахархәаҩцәа мыцҳәарыла рфинанстәи рхатәы информациеи рыцәгара иазкуп.   	Имеется информация о том, что %S является мошенническим веб-сайтом, созданным для того, чтобы обманным путем выманить у пользователей информацию личного или финансового характера.
Имазеиуп, Ирхьиоп	Готово
Афаил аарттәуп	Открыть файл
%S змоу асахьақәа аанкылатәуп	Блокировать изображения с %S
Азин аҭатәуп	Разрешить
Архиарақәа	Настройки
Архынҳәра	Отменить
Ахатәы дыррақәа аныхтәуп…	Удалить личные данные…
Уажә ианыхтәуп	Удалить сейчас
Адаҟьа ацҵатәуп агәлаҵахьы	Добавить страницу в закладки
Ишьақәырӷәӷәоуп: %S	Подтверждено: %S
Ари авеб-саит ахаҭара иазкны аинформациа ыҟам.	Информация о подлинности этого веб-сайта отсутствует.
Идырым	(неизвестен)
Агха	Ошибка
%S аҟынтә зегь ақәгара	Удалить всё из %S
Адомен %S шеибго ақәгара	Удалить домен %S целиком
Аиқәҳәаларҭа ақәгара	Удалить узел
Адомен ақәгара	Удалить домен
Агәлаҵа апанель	Панель закладок
(Иҭацәуп)	(Пусто)
аҟынтә	с
Ирҿыцтәуп	Обновить
Агҽанызаара ҟашәҵала,  агәылаҵа рацәа аартраан %S аусара анарпсыҽуа	Предупреждать, когда открытие множества вкладок может привести к замедлению работы %S
Ахадаратә	Имя:
Ажурнал	Журнал
Аҭагаларақәа	Загрузки
Ахҵа	Метка
Иар&ктәуп	За&крыть
Ахадаратә	Основные
Агәылаҵақәа	Вкладки
Аҵакыра	Содержимое
Ацраԥшьы	Приложения
Лымкаала	Приватность
Ахьчара	Защита
Иацҵаны	Дополнительно
Аусурҭатә еишәа	Рабочий стол
Афаил аиқәырхара	Сохранить файл
Ихархәатәуп (%S)	Использовать %S
Ихархәатәуп %S (ишыҟоу еиԥш)	Использовать %S (по умолчанию)
Ихархәатәуп ҽакы…	Использовать другое…
Ажәабжь ҿыцқәа рлента	Лента новостей
Авидео-подкаст	Видео-подкаст
Аподкаст	Подкаст
Ихархәатәуп %S ( %S аҿы)	Использовать %S (в %S)
Аԥхьахаԥш %S аҿы	Предпросмотр в %S
Аиқәҳәаларҭа	Узел:
Адомен:	Домен:
Асессиа анҵәамҭазы	в конце сессии
Асессиахь азин аҭатәуп (инашьҭтәуп, днашьҭтәуп)	Разрешить на сессию
https://mail.google.com/mail/?extsrc=mailtourl=%s	https://mail.google.com/mail/?extsrc=mailto&url=%s
Ацҵара 	Продолжить
Аиҭагаҩцәа:	Переводчики:
&brandFullName; иазкны	О &brandFullName;
Апрект алахәылацәа.	Участники проекта
&lt; &brandFullName; иазкны	&lt; О &brandFullName;
аверсиа	версия
©1998–2008 Апроект алахәылацәа. Азинқәа зегь хьчоуп. Firefoxи алоготипқәа Firefox хәҳаҳәҭратә маркақәоуп Mozilla Foundation аза. Азинқәа зегь хьчоуп.	©1998–2008 Участники проекта. Все права защищены. Firefox и логотипы Firefox являются торговыми марками Mozilla Foundation. Все права защищены.
Ауаатәыҩс зылшара алазгалаз	Люди внесшие свой вклад
апроект Mozilla ахь 	в проект Mozilla.
Иаԥхьатәуп	Прочитать
алицензиазы адыраҭара 	информацию о лицензии
ари аалыҵ аҿы ахархәара змоу	используемой для этого продукта.
аҭыжьымҭазы азгәаҭа	примечания к выпуску
ари аалыҵ аверсиа	этой версии продукта.
Ахәаԥшра	Просмотреть
аибыҭашьа аконфигурациа	конфигурацию сборки
ари аверсиаҿы ахархәара змоу	используемую в этой версии.
аибыҭара аиԥштәра 	Идентификатор сборки:
Азеиԥш	Общие
Инарҭбаан алшарақәа	Расширенные возможности
Асаитқәа алаԥш рыхгара	Просмотр сайтов
Абраузер ишыҟоу еиԥш	Браузер по умолчанию
Аҳа	Сеть
Аиԥшьра	Соединение
&brandShortName; аиԥшьрақәа ахышәарақәа азшәырхиа; аинтернетахь	Настройте параметры соединения &brandShortName; с Интернет
Ахатә шьҭаҵарҭа	Автономное хранилище
МВ акешаз адискаҿ	МБ на диске для кэша
Аҽырҿыцрақәа	Обновления
...азы ахала аҽырҿыцрақәа гәаҭалатәуп:	Автоматически проверять наличие обновлений для:
&brandShortName; азы аҽыԥсахрақәа аныԥшаахо:	При обнаружении обновлений для &brandShortName;:
Анаҩстәи авеб-саитқәа ахалатә режимаҿ аусуразы ихыхьчеит адыррақәа:	Следующие веб-сайты сохранили данные для работы в автономном режиме:
Аҵакыра (%S)	Содержимое %S
Ари афаилхкы иақәшәо аԥшьқәа ԥшаам	Для данного типа файла ни одного приложения не найдено.
 Аххәаа	Обзор…
Ари афаил ... ахь идәықәҵатәуп	Отправить этот файл в:
Арихиараан агха ҟаҵоуп	Ошибка настройки
Аҽырхиагатә фаил аԥхьараан агха ҟалеит. Асистемат администратор шәидҵаала.	Ошибка при чтении файла настроек. Обратитесь к системному администратору.
Аҽырхиагатә системантә агәҽанызаара 	Предупреждение системы автонастройки
Аелектронтә пошьҭа	Электронная почта
Шәпошҭа аелектронтә адрес анышәҵа 	Введите свой адрес электронной почты
Аԥенџьыр	Окно
Архиарақәа…	Настройки…
Иаҳарбап зегьы	Показать все
Иҵәахтәуп	Скрыть
Ацҵара	Добавить
Агәылаҵа ацҵатәуп	Добавить закладку
Еиҭашьақәыргылатәуп	Восстановить
Ажурнал зегь арбатәуп	Добавить страницу в закладки
Ажәабжьқәа рцәаҳәақәа аёаҵаҩра…	Подписаться на ленты новостей
Иаԥхьааиуа адаҟьахь	На предыдущую страницу
Анаҩстәи адаҟьахь	На следующую страницу
Аҵыхәтәантәи адаҟьақәа	Последние страницы
Уажәтәи адаҟьа рҿыцтәуп	Обновить текущую страницу
Адаҟьа аҭагалара аанкылатәуп	Остановить загрузку страницы
Акьыԥхьра	Печать
Аҭыԥ алхра	Адрес
Аԥшаара	Поиск
Аҩныҟа	Домой
С	C
А	A
Аиаигәа иаркыз агәылаҵақәа	Недавно закрытые вкладки
Аҩныҟатәи адаҟьа	Домашняя страница
Ажурнал зегьы арбатәуп	Показать весь журнал
Аԥенџьыр ҿыц аарттәуп	Открыть новое окно
Аваратәи апанель арктәуп	Закрыть боковую панель
Аҭыҵра ахьынтә (&brandShortName;)	Выход из &brandShortName;
Ари аԥенџьыр уаҳа иааҳмырԥшлап.	Больше не показывать это окно.
Иактиву акурсор	Активный курсор
Апатҟур F7 ақәаӷәараан..  Ари арежим аҟны, акрсор адаҟьаҿ иқәыргыланы, атекст алышәкаар шәлшоит АКЛАВИАТУРА ала. Ари арежим ҿаҳкрыма?	Нажатие клавиши F7 включает или выключает режим активного курсора. В этом режиме, поместив курсор на страницу, вы можете выделять текст с помощью клавиатуры. Включить этот режим?
Ааи	Да
Мап ацәктәуп	Отклонить
Иаалхны	Исключения
Аҭыԥ алхра:	Адрес:
Англызтә (US-ASCII)	Английская (US-ASCII)
Мраҭашәаратәи аевропа (ISO-8859-1)	Западноевропейская (ISO-8859-1)
Европагәҭатәи (ISO-8859-2)	Центральноевропейская (ISO-8859-2)
Аладаевропатәи (ISO-8859-3)	Южноевропейская (ISO-8859-3)
Балтика аҿықәтәи (ISO-8859-4)	Прибалтийская (ISO-8859-4)
Аҭырқәтә (ISO-8859-9)	Турецкая (ISO-8859-9)
Аскандинавтә (ISO-8859-10)	Скандинавская (ISO-8859-10)
Балтика аҿықәтәи (ISO-8859-13)	Прибалтийская (ISO-8859-13)
Кельттәи (ISO-8859-14)	Кельтская (ISO-8859-14)
Мраҭашәараевропатәи (ISO-8859-15)	Западноевропейская (ISO-8859-15)
Арумынтә (ISO-8859-16)	Румынская (ISO-8859-16)
Европагәҭатәи (Windows-1250)	Центральноевропейская (Windows-1250)
Мраҭашәараевропатәи (Windows-1252)	Западноевропейская (Windows-1252)
Аҭырқәатә (Windows-1254)	Турецкая (Windows-1254)
Балтика аҿықәтәи (Windows-1257)	Прибалтийская (Windows-1257)
Мраҭашәараевропатәи (MacRoman)	Западноевропейская (MacRoman)
Европагәҭатәи (MacCE)	Центральноевропейская (MacCE)
Аҭырқәатә (MacTurkish)	Турецкая (MacTurkish)
Ахорваттә (MacCroatian)	Хорватская (MacCroatian)
Арумынтә (MacRomanian)	Румынская (MacRomanian)
Аисландтә (MacIcelandic)	Исландская (MacIcelandic)
Иапониатәи (ISO-2022-JP)	Японская (ISO-2022-JP)
Аиапонтә (Shift_JIS)	Японская (Shift_JIS)
Аиапонтә (EUC-JP)	Японская (EUC-JP)
Акитаитә атрадициатә (Big5)	Китайская традиционная (Big5)
Итардицио акитаитә (Big5-HKSCS)	Китайская традиционная (Big5-HKSCS)
Акитаитә итрадициатәу (EUC-TW)	Китайская традиционная (EUC-TW)
Акитаитә ирмариоу (GB2312)	Китайская упрощённая (GB2312)
Акитаитә ирмарианы (HZ)	Китайская упрощённая (HZ)
Акитаитә ирмарианы (GBK)	Китайская упрощённая (GBK)
Акитаитә ирмарианы (ISO-2022-CN)	Китайская упрощённая (ISO-2022-CN)
Кореиатәи (EUC-KR)	Корейская (EUC-KR)
Акореитә (JOHAB)	Корейская (JOHAB)
Акореитә (UHC)	Корейская (UHC)
Акореитә (ISO-2022-KR)	Корейская (ISO-2022-KR)
Иуникод (UTF-7)	Юникод (UTF-7)
Иуникод (UTF-8)	Юникод (UTF-8)
Аиуникод (UTF-16)	Юникод (UTF-16)
Иуникод (UTF-16 Little Endian)	Юникод (UTF-16 Little Endian)
Иуникод (UTF-16 Big Endian)	Юникод (UTF-16 Big Endian)
Аиуникод (UTF-32 Little Endian)	Юникод (UTF-32 Little Endian)
Иуникод (UTF-32 Big Endian)	Юникод (UTF-32 Big Endian)
Акириллицатә (ISO-8859-5)	Кириллица (ISO-8859-5)
Акириллицатә (ISO-IR-111)	Кириллица (ISO-IR-111)
Акириллицатә (Windows-1251)	Кириллица (Windows-1251)
Акириллицатә (MacCyrillic)	Кириллица (MacCyrillic)
Акириллицатә/Украинатәи (MacUkrainian)	Кириллица/Украина (MacUkrainian)
Акириллицатә (KOI8-R)	Кириллица (KOI8-R)
Акириллицатә/Украинатәи (KOI8-U)	Кириллица/Украина (KOI8-U)
Абырзентә (Windows-1253)	Греческая (Windows-1253)
Абырзентә (MacGreek)	Греческая (MacGreek)
Аветнатә (Windows-1258)	Вьетнамская (Windows-1258)
Аветнатә (TCVN)	Вьетнамская (TCVN)
Аветнатә (VISCII)	Вьетнамская (VISCII)
Аветнатә (VPS)	Вьетнамская (VPS)
Ақырҭтә (GEOSTD8)	Грузинская (GEOSTD8)
Атаитә (TIS-620)	Тайская (TIS-620)
Атаитә (Windows-874)	Тайская (Windows-874)
Атаитә (IBM-874)	Тайская (IBM-874)
Аерманытә (ARMSCII-8)	Армянская (ARMSCII-8)
Арабтә (ISO-8859-6)	Арабская (ISO-8859-6)
Арабтә (ISO-8859-6-I)	Арабская (ISO-8859-6-I)
Арабтә (ISO-8859-6-E)	Арабская (ISO-8859-6-E)
Ауриатә (ISO-8859-8)	Иврит (ISO-8859-8)
Ауриатә (ISO-8859-8-I)	Иврит (ISO-8859-8-I)
Ауриатә (ISO-8859-8-E)	Иврит (ISO-8859-8-E)
Ауриатә (Windows-1255)	Иврит (Windows-1255)
Арабтә (Windows-1256)	Арабская (Windows-1256)
Ахархәаҩ ишаирбо ала	Определённая пользователем
Акириллицатә/Урыстәыла (CP-866)	Кириллица/Россия (CP-866)
Мраҭашәаратәи аевроппа (IBM-850)	Западноевропейская (IBM-850)
Акириллицатә (IBM-855)	Кириллица (IBM-855)
Аҭырқәатә (IBM-857)	Турецкая (IBM-857)
Ауриатә (IBM-862)	Иврит (IBM-862)
Арабтә (IBM-864)	Арабская (IBM-864)
Арабтә (IBM-864-I)	Арабская (IBM-864-I)
Акитаитә ирмарианы (GB18030)	Китайская упрощённая (GB18030)
Арабтә (MacArabic)	Арабская (MacArabic)
Арабтә (Langbox ISO-8859-6.8x)	Арабская (Langbox ISO-8859-6.8x)
Арабтә (Langbox ISO-8859-6.16)	Арабская (Langbox ISO-8859-6.16)
Ауриатә (MacHebrew)	Иврит (MacHebrew)
Ахинди (MacDevanagari)	Хинди (MacDevanagari)
Агәыджаратә (MacGujarati)	Гуджарати (MacGujarati)
(Иаҿыхуп)	(Отключено)
Ауниверсалтә	Универсальная
Аиапонтә	Японская
Акореиатә	Корейская
Акитаитә итрадициатәу	Традиционная китайская
Акитаитә ирмариоу	Упрощённая китайская
Акитаитә	Китайская
Мрагылара азиатәи	Восточноазиатская
Аурыстә	Русская
Аукраинатә	Украинская
Аԥштәқәа	Цвета
Икьаҿу ахы	Краткий заголовок
Иабалакгьи атекст аҿарԥштәы.	Пример какого-либо текста.
Ахархәаҩ ихьӡ:	Имя пользователя:
Амаӡажәа:	Пароль:
Амаӡажәа аиҭаҵабыргра:	Подтверждение пароля:
Агәҽанҵара	Предупреждение
Арҵабыргра	Подтверждение
Ааԥхьара	Приглашение
Аутентификациа ахәҭоуп	Требуется аутентификация
Амаӡажәа ахәҭоуп	Требуется пароль
Аилых	Выбор
Архынҳәра	Отмена
Аиқәырхара	&Сохранить
[JavaScript ацҵаԥшьы]	[Приложение JavaScript]
Адаҟьа %S аҟны адырра ҳанаҭоит:	Страница на %S сообщает:
Шәгәышәҽаныз, мамзар гарантиада шәаанхоит!	Будьте осторожны, а то лишитесь гарантии!
Агәра шәсыргоит сыгәыҽанызааует (агәҽанызара)!	Я обещаю, что буду осторожен!
 Ари агәҽанҵара анеиҩс еҭах иааҳарԥшлап	Показывать это предупреждение в следующий раз
Аҭагылазаашьа	Состояние
Иҭоу аҵакы	Тип
Аҵакы	Значение
Аилыхразы шәақәыӷа	Нажмите для сортировки
Шәақәыӷәа, аколонкақәа аарԥшаразы	Нажмите, чтобы выбрать колонки для отображения
ҿымҭра ала	по умолчанию
ахархәаҩ ишықәиргылаз	установлено пользователем
иаанкылоп	заблокировано
ацәаҳа	строка
еибго	целое
алогикатә	логическое
(%S) аҵакы ҿыц	Новое значение (%S)
Ашьақәыргыла ахьӡ ҭажәгал	Введите имя настройки
(%S) аҵакы ҭажәгал	Введите значение (%S)
Аҽаԥшьырҭа:	Порт:
Агхақәа рконсол	Консоль ошибок
Аӡхы:	Источник:
Ацәаҳәа:	Строка:
Асимвол:	Символ:
Агха:	Ошибка:
Агәыҽанҵара	Предупреждение:
Аӡхы: %S	Источник: %S
Ацәаҳәа: %S	Строка: %S
Ацәаҳәа: %S, асимвол %S	Строка %S, символ %S
Аӡхытә код:	Исходный код:
Асахьа еқәхархап	Сохранение изображения
Ишԥа еқәырхатәу	Сохранить как
Уеб-даҟьа, инҭырҳәацааны	Веб-страница, полностью
Уеб-даҟьа, HTML мацара	Веб-страница, только HTML
Уеб-даҟьа, XHTML мацара	Веб-страница, только XHTML
Уеб-даҟьа, SVG мацара	Веб-страница, только SVG
Уеб-даҟьа, ХML мацара	Веб-страница, только XML
Абызшәақәа	Языки
Иалышәх абызшәа авеб даҟьаҿ ижәбарц ишәҭаху	Выберите язык, предпочитаемый вами для отображения веб-страниц
Иҭоу // иагәылоу	Содержимое:
Амҩа:	Путь:
Ишьҭлатәуп … аан	Отправлять при:
Ахархәара аамҭа нҵәоит:	Срок действия истекает:
Аполитика:	Политика:
 cookie шеиқәырхоу ала арҵабыргра	Подтверждение сохранения cookie
иԥкаауа зегь аарԥштәуп	Показать подробности
... Ҵәахтәуп	Скрыть подробности
Асаит %S  cookie еиқәнархац аҭахуп.	Сайт %S хочет сохранить cookie.
Асаит %S аҩбатъи cookie еиқәнархарц агәы иҭоуп.	Сайт %S собирается сохранить второй cookie.
Асаит %S ийоу cookie а8сахырц а0ахуп.	Сайт %S хочет изменить существующий cookie.
Аилаҳара иазкәы адрырраҭа инашьҭыз	Отправленные сообщения о падениях
Адырраҭа аиндификатор	Идентификатор сообщения
Анашьҭраантәи арыцхә	Дата отправки
Аилаҳара иазкәы адрырраҭакгьи нашьҭымызт	Ни одного сообщения о падении отправлено не было.
Ари ацраԥшьы шьқәыргыламызт аиқәаҳара адыррҭа аарԥшраз . Апораметр <code>breakpad.reportURL</code> ықәаргылатәп.	Это приложение не было настроено на отображение сообщений о падениях. Необходимо установить параметр <code>breakpad.reportURL</code>.
Адырраҭа ықәаҳгап	Удалить сообщения
Агәраганы шәыҟома?	Вы уверены?
Ари адырраҭақәу зегь ықәнагоит архынҳәрагь аухаӡом.	Это удалит все сообщения и не может быть отменено.
Астилқәа рҭаӡҩырҭа %1$S ҭагаламызт, избанзар иара MIME-тип («%2$S») «text/css» акәыӡам.	Таблица стилей %1$S не была загружена, потому что её MIME-тип («%2$S») не «text/css».
Аҭаӡҩырҭақәа рыстил %1$S ҭагалан MIME-тип («%2$S»)  «text/css» шакумызгьи.	Таблица стилей %1$S была загружена, хотя её MIME-тип («%2$S») не «text/css».
%1$S аԥшаараан ҳазқәымгәӷәуаз аҵыхәтәы.	Неожиданный конец файла при поиске %1$S.
Ацәаҳәа абжажьқәа рыла еиҿкаауп, астил адескриптор еиԥш аинтерпритациа азыухоит.	Строка состоит из пробелов, и будет интерпретирована как дескриптор стиля.
Ицәыӡу аиҭарҿыцра.	Потерянное объявление.
Ибжьажьуп анеиҩстәи аиҭарҿыцра аҟынӡа.	Пропущено до следующего объявления.
«%1$S» еилкаам аҟазшьа.	Неизвестное свойство «%1$S».
«%1$S» аҟазшьа аҵакы анализ азыураантәи агха.	Ошибка при анализе значения свойства «%1$S».
Аҵакы аҟазшьа аҵыхәтәы ҳақәгыӷәан, аха иԥшшаахаз «%1$S» ауп.	Ожидался конец значения свойства, но найдено «%1$S».
Еилкаам at-ԥҟара аҵахәтәы	конец неопознанного at-правила
Елкаам at-ԥҟара ма «%1$S» анализ азыураантәи агха.	Неизвестное at-правило или ошибка при анализе «%1$S».
 @charset аԥҟараҿ ацәаҳәақәа ркодировка	кодировка строк в правиле @charset
Акодировкатә цәаҳәа ҳақәгыӷәан, аха иԥшшаахаз «%1$S» ауп.	Ожидалась строка кодировки, но найдено «%1$S».
@import ма @media аԥҟарраҿы медиа ахьӡанҵаҿы хыркәшоп	конец списка медиа в @import или @media правиле
Медиа ахьӡанҵаҿы «,»ҳазыԥшын, иаҳаԥшааз «%1$S».	Ожидалась «,» в списке медиа, но найдено «%1$S».
Медиа ахьӡынҵаҟнф аидентификатор ҳақәгыӷәан, аха иԥшшаахаз «%1$S» ауп.	Ожидался идентификатор в списке медиа, но найдено «%1$S».
@import аԥҟараҿ URI ҳақәгыӷәан, аха иԥшшаахаз «%1$S» ауп.	Ожидался URI в правиле @import, но найден «%1$S».
@import аҩныҵҟа ҳазқәымгәыӷәаз «%1$S» ԥшаауп.	Найдено неожиданное «%1$S» внутри @import.
 @media ма @-moz-document аԥҟара аҵыхәтәы	конец правила @media или @-moz-document
@-moz-document аԥҟарраҿ url(), url-prefix() ма domain()  ҳақәгыӷәан, аха иԥшшаахаз «%1$S» ауп.	Ожидались url(), url-prefix() или domain() в правиле @-moz-document, но найдено «%1$S».
 @-moz-document адокумент аԥҟараҿы URI ҳақәгыӷәан, аха иԥшшаахаз «%1$S» ауп.	Ожидался URI в правиле @-moz-document, но найдено «%1$S».
@namespace аԥҟараҿы ахьӡқәа еиужьра апрефикс	префикс пространства имён в правиле @namespace
 @namespace аԥҟараҿы ахьӡқәа реиужьра URI	пространство имён URI в правиле @namespace
. @namespace аҩныҵҟа ҳазқәымгыӷыц адырга: «%1$S».	Неожиданный символ внутри @namespace: «%1$S».
аиҭарҿыцра } иазыркәа	закрывающая } объявления
ииашам аԥҟара } аркыга	закрывающая } неверного правила
Аселектор хьҽеим азы апҟара елагоу.	Правило проигнорировано из-за плохого селектора.
«,» ма «{»	«,» или «{»
«,» ма «{» ҳақәгыӷәан, аха иԥшшаахаз «%1$S» ауп.	Ожидались «,» или «{», но найдено «%1$S».
Аселектор ҳазыԥшуп.	Ожидается селектор.
Акласс ахьӡ	имя класса
Акласс аселектор азы аидентификатор ҳазыԥшын, амала иԥшаахаз «%1$S».	Ожидался идентификатор для селектора класса, но найдено «%1$S».
Аелимент атип	тип элемента
аелемент ахьӡ ма «*» ҳақәгыӷәан, аха иԥшшаахаз «%1$S» ауп.	Ожидалось имя элемента или «*», но найдено «%1$S».
Ахьӡқәа реиужьраҟны «%1$S» еилкаам апрефикс.	Неизвестный префикс пространства имён «%1$S».
Атрибуҭ ахьӡ	имя атрибута
Атрибут ахьӡ азы аидентификатор ҳақәгыӷәан, аха иԥшшаахаз «%1$S» ауп.	Ожидался идентификатор для имени атрибута, но найдено «%1$S».
Атрибут ма ахьӡқәа реиужьра ҳазыԥшын, амала иԥшаахаз «%1$S».	Ожидались имя атрибута или пространство имён, но найдено «%1$S».
«|» ҳақәгыӷәан, аха иԥшшаахаз «%1$S» ауп.	Ожидалось «|» , но найдено «%1$S».
аселектор атрибут ахәҭа	часть селектора атрибута
Аселектор атрибутаҿ игәанҽамыз адырга: «%1$S».	Неожиданный символ в атрибуте селектора : «%1$S».
атрибут аҵакы	значение атрибута
аселектор атрибут аҵыхәтәанынӡа «]»	«]» до конца атрибута селектора
Аселектор атрибут аҵыхәтәанынӡа «]» ҳақәгыӷәан, аха иԥшшаахаз «%1$S» ауп.	Ожидалось «]» до окончания атрибута селектора, но найдено «%1$S».
ҳақәгыӷәан, аха иԥшшаахаз «%1$S» ауп.	Ожидались идентификатор или строка для значения атрибута селектора, но найдено «%1$S».
псевдо-класс ма апсевдо-елемент ахьӡ	имя псевдо-класса или псевдо-элемента
Аидентификатор апсевдо-класс ма апсевдо-ҽлемент азы ҳақәгыӷәан, аха иԥшшаахаз «%1$S» ауп.	Ожидался идентификатор для псевдо-класса или псевдо-элемента, но найдено «%1$S».
Апсевдо-елемет ҳақәгыӷәан, аха иԥшшаахаз «%1$S» ауп.	Ожидался псевдо-элемент, но найдено «%1$S».
Ари апсевдо-елемент ахы анархәароп «::» аформ: «%1$S».	Этот псевдо-элемент должен использовать «::» форму: «%1$S».
Аԥсевдо-елемент анаҩыс аркыгап дырга ԥшаауп, аселектор анҵәанҭатә хәҭакеиԥш иҟазароуп: «%1$S».	После псевдо-элемента найден закрывающий символ, который должен быть конечной частью селектора: «%1$S».
Ахарҭәаатә псевдо-елемент «%1$S».	Дополнительный псевдо-элемент «%1$S».
Еилкаам псевдо-класс ма псеудо-елемент «%1$S».	Неизвестный псевдо-класс или псевдо-элемент «%1$S».
селектор мап акра аҩныҵҟа	селектор внутри отрицания
Уаҩҵас еиҿкаам имариоу аселектор ....	Плохо сформированный простой селектор в качестве аргумента «%1$S» отрицающего псевдо-класса.
«)» «%1$S»	Потеряна закрывающая «)» в отрицающем псевдо-классе «%1$S».
Апсевдо-класс мапацәызкәа аргумент  «%1$S» ыӡуп. 	Потерян аргумент отрицающего псевдо-класса «%1$S».
Псевдо-класс аргумент аселектор	аргумент селектора псевдо-класса
Апсевдо-класс апараметр аидентификатор ҳазыԥшын, аха иԥшшаахаз «%1$S» ауп.	Ожидался идентификатор параметра псевдо-класса, но найдено «%1$S».
Апсевдо-класс аргумент ахәҭак ҳақәыгыӷәан, аха иԥшшаахаз «%1$S» ауп.	Ожидалась часть аргумента псевдо-класса, но найдено «%1$S».
Апсевдо-классаҟны «)» азыркәа цәӡуп, иԥшшаахаз «%1$S» ауп.	Потеряна закрывающая «)» в псевдо-классе, найдена «%1$S».
Апсевдо-классаҿ «%1$S» аргумент ыӡуп.	Потерян аргумент в псевдо-классе «%1$S».
Адырраҭарақәа рыблок алагамҭаз «{» ҳазыԥшын, амала иԥшаахаз «%1$S».	Ожидалась «{» — начало блока объявления, но найдено «%1$S».
аԥшхәытәқәа	цвета
Аԥшхәтәы аилкаара ҳақәгыӷәан, аха иԥшшаахаз «%1$S» ауп.	Ожидалось определение цвета, но найдено «%1$S».
аԥшхәтәы акомпанент	компоненты цвета
Апрцетә ҵакы ҳақәгыӷәан, аха иԥшшаахаз «%1$S» ауп.	Ожидалось процентное значение, но найдено «%1$S».
Арыцхәыеибга ҳақәгыӷәан, аха иԥшшаахаз «%1$S» ауп.	Ожидалось целочисленное значение, но найдено «%1$S».
Апроцентә ма арыцхәтә цакы ҳақәгыӷәан, аха иԥшшаахаз «%1$S» ауп.	Ожидалось численное или процентное значение в rgb(), но найдено «%1$S».
«%2$S» ҳақәгыӷәан, аха иԥшшаахаз «%1$S» ауп.	Ожидалось «%2$S», но найдено «%1$S».
ацәаԥштәхәы	оттенок
«,» ҳазыԥшын, амала иԥшаахаз «%1$S».	Ожидалась «,» но найдено «%1$S».
аԥшхәтәы аҵакаҿы кеикеиым	непрозрачность в значении цвета
Анумер ҳақәгыӷәан, аха иԥшшаахаз «%1$S» ауп.	Ожидался номер, но найдено «%1$S».
«)» ҳақәгыӷәан, аха иԥшшаахаз «%1$S» ауп.	Ожидалась «)», но найдено «%1$S».
«;» ма «}» аҭарҿыцра аҵыхәтәазы	«;» или «}» для конца объявления
«:» Ҳазыԥшын, амала иаҳзымԥшааит «%1$S»	Ожидалось «:», но найдено «%1$S».
Адырраҭа ҳақәгыӷәан, аха иԥшшаахаз «%1$S» ауп.	Ожидалось объявление, но найдено «%1$S».
Адырраҭара аҵыхәтәы	конец объявления
ихадароуп	важно
«important» ҳазыԥшын, амала иԥшаахаз «%1$S».	Ожидалось «important», но найдено «%1$S».
Иазыркәа «;» ҳақәгыӷәан, аха иԥшшаахаз «%1$S» ауп.	Ожидалась «;» закрывающая объявление, но найдено «%1$S».
«;» ма «}» адырраҭара азыркәа азыԥшын, амала иԥшаахаз «%1$S».	Ожидались «;» или «}» закрывающие объявление, но найдено «%1$S».
Аҩныҵҟатәи аҟазшьа аҵакы аҭара сылшом.	Не могу задать значение внутреннего свойства.
Иаркым ацәаҳәа «%1$S» ԥшаауп.	Найдена незакрытая строка «%1$S».
Акодировкап шьақәылара	Настройка кодировки
Иактиву кодировкақәа:	Активные кодировки:
Иаԥыхтә&уп	&Удалить
Иҳанашьо акодировкақәа:	Доступные кодировки:
Аелиментқәа ацҵареи ақәгареи шәылшоит амыруыгақәа рпонелаҿ, аҳәынапала етаганы.	Вы можете добавлять или удалять элементы на панелях инструментов, перетаскивая их мышью.
Иааҳарԥшлап:	Показывать:
Атексти адыргақәеи	Значки и текст
Аҵакы мацара	Только значки
Атекст мацара	Только текст
Адыргақәасса	Маленькие значки
Апонел ацаҳҵап	Добавить панель
Аиҭакрақәа ҳархынҳәып	Отменить изменения
Амыруыгақәа панел ҿыц	Новая панель инструментов
Амыруыгақәа  панел ахьӡ ҭажәгал:	Введите имя панели инструментов:
Амыруыгақәа понел «%S» ахьӡ змо ыҟоп. Ҽа хьӡык ҭажәгал.	Панель инструментов с именем «%S» уже существует. Введите другое имя.
Амыруыгақәа панел аԥҵаразы ахьӡ ҿыц ҭажәгал.	Чтобы создать новую панель инструментов вы должны ввести для неё имя.
Аийъшага	Разделитель
Зҽызыԥсахәа аура аинтервал	Интервал изменяемой длины
Аинтервал	Интервал
Акәамаҵамақәа	Подробности
Аилыркаага	Справка
Ицрыԥшьу адыррақәа	Дополнительные сведения
Агәцаракра: Асценари аҭак ҟанаҵом	Внимание: Сценарий не отвечает
Иҟалар ҟалап  ари адаҟьаҿы инанагӡо асценари аҭак ҟанаҵом ма елахоп. Иара уажәы аанкылар шәылшоит ма иацҵаны шәахәыԥш аус ахыркәшара алшома.	Сценарий, исполняемый на этой странице, возможно занят или не отвечает. Вы можете остановить его сейчас или продолжить и посмотреть сможет ли он завершить свою работу.
Иҟалар ҟалап  ари адаҟьаҿы инанагӡо асценари аҭак ҟанаҵом ма елахоп. Иара уажәы аанышәкылар шәылшоит, 	Сценарий исполняемый на этой странице возможно занят или не отвечает. Вы можете остановить его сейчас, открыть сценарий в отладчике или позволить сценарию продолжить свою работу.
Асценари: %S	Сценарий: %S
Асценари аанкылара	Остановить сценарий
Асценари арҽеира	Отладка сценария
Асценари аԥенџьер аркра алшом, ҽасценариак ала иаарту.	Сценарии не могут закрывать окна, открытые другими сценариями.
Ари адаҟьантә шәцарц шышәҭахәы агәыраганы шәыҟома?	Вы уверены, что хотите уйти с этой страницы?
Истандартным document.all аҟазшьа архәан. Иара аҭыԥан document.getElementById() W3C иҳаднагало.	Было использовано нестандартное свойство document.all. Вместо него следует использовать свойство document.getElementById() рекомендованное W3C.
Аметод captureEvents() уаҳа адгылара амам. Иара аԥсахразы, аметод addEventListener()  DOM 2 аҟынтә шәыхы ашәырхәы. Иаҳа еиԥкаау аинформациа http://developer.mozilla.org/en/docs/DOM:element.addEventListener ара ишьҭоуп.	Метод captureEvents() больше не поддерживается. Для его замены используйте метод addEventListener() из DOM 2. Более подробная информация доступна на http://developer.mozilla.org/en/docs/DOM:element.addEventListener
Аметод releaseEvents() уаҳа адгылара амам. Иара аԥсахразы аметод removeEventListener()  DOM 2 аҟынтә шәыхы ашәырхәы. Иаҳа еиԥкаау аинформациа http://developer.mozilla.org/en/docs/DOM:element.removeEventListener ара ишьҭоуп.	Метод releaseEvents() больше не поддерживается. Для его замены используйте метод removeEventListener() из DOM 2. Более подробная информация доступна на http://developer.mozilla.org/en/docs/DOM:element.removeEventListener
Аметод routeEvent() уаҳа адгылара амам. Иара аԥсахразы, аметод dispatchEvent()  DOM 2 аҟынтә шәыхы ашәырхәы. Иаҳа еиԥкаау аинформациа http://developer.mozilla.org/en/docs/DOM:element.dispatchEvent ара ишьҭоуп.	Метод routeEvent() больше не поддерживается. Для его замены используйте метод dispatchEvent() из DOM 2. Более подробная информация доступна на http://developer.mozilla.org/en/docs/DOM:element.dispatchEvent
Event=%S, preventBubble() ахархәара уаҳа адгылом. Уи аҭыԥан stopPropagation() ашәырхәала, W3C иҳаднагало.	Event=%S, использование preventBubble() больше не поддерживается. Вместо него следует использовать stopPropagation() рекомендованный W3C.
Event=%S, preventCapture() ахархәара уаҳа адгылом. Уи аҭыԥан stopPropagation() ашәырхәала, W3C иҳаднагало.	Event=%S, использование preventCapture() больше не поддерживается. Вместо него следует использовать stopPropagation() рекомендованный W3C.
getBoxObjectFor() архәара ҳазыразӡам. Алшара ыҟазар element.getBoundingClientRect() шәхы ашәырхәы.	Использование getBoxObjectFor() не рекомендуется. Если возможно, попробуйте использовать element.getBoundingClientRect().
canvas: strokeStyle ма fillStyle ицәаҳәам аҵакахьы ақәыргылара аҽазшәара мамзаргьы CanvasGradient ма CanvasPattern иатәанабеит.  	canvas: попытка установить strokeStyle или fillStyle в значение не являющееся строкой, либо CanvasGradient или CanvasPattern были проигнорированы.
Иҭацәу адаҟьа, getElementById() аметод азы аргуметӡам.	Пустая строка не может быть аргументом метода getElementById().
Аплагинаҿ иақәынагам операциа	Недопустимая операция в плагине
Аплагин иақәынагам операциа ҟанаҵеит. 	Плагин выполнил недопустимую операцию. Настоятельно рекомендуется перезапустить %S.
Ҳазҭагыло асиансаҿ ари адырраҭа уаҳа ааҳмырԥшлап.	Больше не показывать данное сообщение во время текущего сеанса.
Аԥшаара…	Поиск…
Ишьахәуп	Отменено
#1 из #3 #5	#1 из #3 #4
#1 #2 из #3 #5	#1 #2 из #3 #4
Осталось #2	Осталось #1
#1 — #3	#1 — #2
ресурс #2	ресурс #1
Иацы	Вчера
Уашьҭан азҵаара аҭахӡам	Не спрашивать в следующий раз
Аҭаӡ:	Папка:
Алхра…	Выбрать…
Агхақәа	Ошибки
Ахартәаара	Дополнения
Аинтернет аҿы аԥшаара	Поиск дополнений
Ахкырбагақәа	Расширения
Атемақәа	Темы
Аҭыԥыркрақәа	Локализации
Аплагинқәа	Плагины
Иаԥыхтәуп	Удалить
Азыԥшра…	Ожидание…
Аҿыхра 	Отключить
Мап	Нет
Ахкырбагақәа (*.xpi)	Расширения (*.xpi)
Ахьыӡ	Имя
Ашәагаа	Размер
Аҵыхәтантәи аиҭакрақәа:	Последнее изменение
Ари акоталог ахәыԥшраз иахәҭо азин шәымам.	У вас нет необходимых прав для просмотра этого каталога.
Ҩаӡарак 	Перейти на уровень выше
Аҩныҟатәи адаҟьахь ҳаиасып	Перейти на домашнюю страницу
Акаталог ҿыц ԥаҳҵап	Создать новый каталог
Афаилқәа зегьы	Все файлы
HTML	HTML-файлы
Атекстә фаил	Текстовые файлы
XML-афаилқәа	XML-файлы
XUL	XUL-файлы
Акаталог ахьӡ	Имя каталога:
Аиқәырхара	Сохранить
Ишԥаеиқәырхатәу:	Сохранить как:
«%S» афаил ыҟаӡам	Файл «%S» не существует
Афалахь «%S» аазнеираан агха	Ошибка доступа к «%S»
Акаталог «%S» ыҟаӡам	Каталог «%S» не существует
Афаил «%S» аԥхьараан агха	Ошибка чтения файла «%S»
Аиқәырхааран агха«%S»	Ошибка сохранения «%S»
«%S» ыаилуп, «%S» аиқәырхара залымшахеит.	«%S» является файлом, не удалось сохранить «%S»
«%S» амҩа ыҟаӡам, «%S» ақәрхара залымшеит	Путь «%S» не существует, не удалось сохранить «%S»
Афаил «%S» аҭаҩразы аркәып	Файл «%S» недоступен для записи.
Афаил аԥҵараантәи агха. Акаталог «%S» аҭаҩра зыҳәан аркуп.	Ошибка создания файла. Каталог «%S» недоступен для записи.
«%S» аԥҵараан агха	Ошибка создания «%S»
Акаталог аԥҵараан агха, афаил «%S» ахьӡ зхәы ыҟоп.	Ошибка создания каталога, файл с именем «%S» уже существует.
Акаталог «%S» аԥцараан агха	Ошибка создания каталога «%S»
Акаталог аԥҵараан агха, «%S» фаилуп	Ошибка создания каталога, «%S» является файлом
Акоталог аԥҵараан агха, «%S» аҭаҩра залымшеит	Ошибка создания каталога, запись в «%S» не удалась
Акоталог аԥҵара	Создание каталога
Елкаам агха	Неизвестная ошибка
Еилкаам агха ҟалеит(амҩа:«%S»)	Произошла неизвестная ошибка (путь: «%S»)
Аԥшааратә панел аркра	Закрыть панель поиска
Афраза ԥшаам	Фраза не найдена
Адаҟьа аладара наӡоуп, аҩадантә иацҵоуп	Достигнут низ страницы, продолжено сверху
Адаҟьа аҩаӡарахь наӡоуп, аладантәи иацуп	Достигнут верх страницы, продолжено снизу
Аԥшаара:	Найти:
Лассытәи аԥшаара:	Быстрый поиск:
Лассытәи аԥшаара(азхьарԥш мацара):	Быстрый поиск (только ссылки):
%S аиқәшәара	%S совпадение
Аиқәшәарақәа:%S	Совпадений: %S
Аиқәшәарақәа %S иреҳауп	Более %S совпадений
Ари адаҟьаҿ аԥшаара	Найти на этой странице
Ахырхарҭа	Направление
Иалышәкааз атекст ԥшааӡам	Введённый вами текст не найден.
Аԥшаара	Найти
Ашрифтқәа	Шрифты
Иапонтәи	Японский
Кореитәи	Корейский
Акириллицатә	Кириллица
Гречетәи	Греческий
Аҭырқәатә	Турецкий
Таитәи	Тайский
Тамильтәи	Тамильский
Аерматә	Армянский
Бенгальтәи	Бенгальский
Ақырҭуатә	Грузинский
Кхмертәи	Кхмерский
Орииа	Ория
Сингалтәи	Сингальский
Акодркра	Кодировка
Еилкаам агха ҟалеит (%1$S)	Произошла неизвестная ошибка (%1$S)
Аҷыдаҟазшьақәа	Свойства
Хазы иҟоу аобласт	Отдельные области
Иалкаау _аобласть	Выделенную _область
_Аобласть цыԥхьаӡа хаз-хазыла	_Каждую область по отдельности
Амасштабҟаҵара хьаас имкыкәа адаҟьа аҭбаарала аиҵырӷәара	Игнорировать масштабирование и с_жать по ширине страницы
Иалкаау _аобласть мацара	Только _выделенную область
Аҵҟьа	Фон
Аҵаԥшхәтәы апринтер _аҿыгара	Печатать цвет _фона
Аҵасахьа апринтер _аҿыгара	Печатать фоновое _изображение
Аколантитулқәа	Колонтитулы
Арымарахьтә	Слева
Агәҭала	По центру
Аилкаага	Справа
--иҭацәуп--	--пусто--
Адаҟьа ахы	Заголовок страницы
Адаҟьа адрес	Адрес страницы
Арыцхәи аамҭеи	Дата и время
Адаҟьа анумер	Номер страницы
Адаҟьа # аҟынтә #	Страница # из #
Ашьақәыргылара...	Настроить…
Аколантитул азы шәтекст ҭажәгал	Введите собственный текст колонтитула
Ахкы	Тип
Иахьа	Сегодня
%S мш. Раԥхьа	%S дн. назад
(аиқәҳәаларҭа ыҟам)	(нет узла)
Аԥыхра	Сброс
Адҵаалара анашьҭра	Отправить запрос
Аххәаа	Обзор…
Афаил аҭагалара	Загрузка файла
Ари адокумент аԥшаатә ҳаднагалоит. Ихадоу ажәақәа ҭажәгал:	Этот документ предоставляет поиск. Введите ключевые слова:
Аформа «enctype=%S» атрибут амокп, амала «method=post» атрибут амаӡам. Уи аҭыԥан адыррақәа рынашьҭраз аметод «GET» архәахоит, иамоу атип амырбакәа.  	Форма содержит атрибут «enctype=%S», но не содержит атрибут «method=post». Вместо этого для отправки данных будет использоваться метод «GET» без указания типа содержимого.
Афаил аҭагаларазы аформа азин ҳанаҭоит, амала «method=POST» нас «enctype=multipart/form-data» атрибутқәа арбаӡам. Афаил анашьҭра залшом.	Форма разрешает загрузку файла, но не указаны атрибуты «method=POST» и «enctype=multipart/form-data». Файл не будет отправлен.
Аформа %S аҟынтә анашьҭра	Отправка формы из %S
ISO-8859-1, ISO-8859-15, IBM850, x-mac-roman, windows-1252, ISO-8859-14, ISO-8859-7, x-mac-greek, windows-1253, x-mac-icelandic, ISO-8859-10, ISO-8859-4	ISO-8859-1, ISO-8859-15, IBM850, x-mac-roman, windows-1252, ISO-8859-14, ISO-8859-7, x-mac-greek, windows-1253, x-mac-icelandic, ISO-8859-10, ISO-8859-3
Хыхь	Вверх
Алада	Вниз
Армарахь	Влево
Арӷьарахь	Вправо
Аԥсшәатә	Абхазский
Авестиитәи	Авестийский
Амхартәи	Амхарский
Арагонтәи	Арагонский
Арабтәи	Арабский
Ассамтәи	Ассамский
Астурийтәи	Астурийский
Авартәи	Аварский
Аимара	Аймара
Азербаџьантәи	Азербайджанский
Башкиртәи	Башкирский
Белорустәи	Белорусский
Болгартәи	Болгарский
Бихартәи	Бихарский
Бамбартәи	Бамбарский
Тибеттәи	Тибетский
Бретонтәи	Бретонский
Босниитәи	Боснийский
Каталантәи	Каталанский
Чечентәи	Чеченский
Корсикантәи	Корсиканский
Чештәи	Чешский
Ауахәамаславиантәи	Церковнославянский
Чуваштәи	Чувашский
Валлиитәи	Валлийский
Даттәи	Датский
Анемецтәи	Немецкий
Дзонг-ке	Дзонг-кэ
Еве	Эве
Англызтәи	Английский
Испантәи	Испанский
Естонтәи	Эстонский
Еускара	Эускара
Персидтәи	Персидский
Финтәи	Финский
Фарертәи	Фарерский
Французтәи	Французский
Фриультәи	Фриульский
Фризтәи	Фризский
Ирландтәи	Ирландский
Шотландтәи гелтәи	Шотландский гэльский
Галисиитәи	Галисийский
Менсктәи	Мэнский
Хорваттәи	Хорватский
Лужицтәи хыхьтәи	Верхний лужицкий
Гаитиантәи	Гаитянский
Венгертәи	Венгерский
Индонезиитәи	Индонезийский
Сычуан-Ии	Сычуань-Йи
Исландтәи	Исландский
Италиатә	Итальянский
Иавантәи	Яванский
Кикуииу	Кикуйю
Киниама	Киньяма
Казахтәи	Казахский
Гренландтәи	Гренландский
Курдтәи	Курдский
Корнстәи	Корнский
Киргизтәи	Киргизский
Латинтәи	Латинский
Люксембургтәи	Люксембургский
Лимбургтәи	Лимбургский
Лаостәи	Лаосский
Литовтәи	Литовский
Латыштәи	Латышский
Малагасиитәи	Малагасийский
Маршальтәи	Маршальский
Македонтәи	Македонский
Малаиалам	Малаялам
Монголтәи	Монгольский
Молдавтәи	Молдавский
Малаитәи	Малайский
Мальтиитәи	Мальтийский
Бирмантәи	Бирманский
Норвежтәи Букмол	Норвежский Букмол
Ндебеле, Аҩадатә	Ндебеле, Северный
Непалтәи	Непальский
Голландтәи	Голландский
Норвежтәи Ниунорск	Норвежский Нюнорск
Норвежтәи	Норвежский
Ндебеле, Аладатә	Ндебеле, Южный
Сото, Аҩадатә	Сото, Северный
Окситантәи	Окситанский
Осетинтәи	Осетинский
Польтәи	Польский
Португальтәи	Португальский
Реторомантәи	Ретороманский
Румынтәи	Румынский
Аурыстә	Русский
Сардинтәи	Сардинский
Аҩадатә Сами	Северный Сами
Словацтәи	Словацкий
Словентәи	Словенский
Самоантәи	Самоанский
Албантәи	Албанский
Сербтәи	Сербский
Сото, Аладатә	Сото, Южный
Сундантәи	Сунданский
Шведтәи	Шведский
Таджиктәи	Таджикский
Тигриниа	Тигринья
Туркментәи	Туркменский
Тагальтәи	Тагальский
Клингонтәи	Клингонский
Татартәи	Татарский
Таитиантәи	Таитянский
Уигуртәи	Уйгурский
Украинтәи	Украинский
Узбектәи	Узбекский
Вьетнамтәи	Вьетнамский
Волапиук	Волапюк
Валлонтәи	Валлонский
Лужицтәи	Лужицкий
Иоруба	Йоруба
Чжуан	Чжуань
Китаитәи	Китайский
Адәықәҵара	Запуск
Аҩныҟатә даҟьа арбатәуп	Показать домашнюю страницу
Иҭацәу адаҟьа арбатәуп	Показать пустую страницу
Аԥаса иаартыз аԥенџьырқәеи агәылаҵақәеи арбатәуп	Показать окна и вкладки, открытые в прошлый раз
Уажәтәи адакьақәа хархәатәуп	Использовать текущие страницы
Шәхарҭәаарақәа рхышәарақәа шәыԥсах	Измените параметры ваших дополнений
%S (сахьаҭыхымҭа «%S», %Sx%Sпиксел амоуп)	%S (изображение «%S», %Sx%S пикселов)
%S (асахьаҭыхымҭа «%S»)	%S (изображение «%S»)
(Асахьаҭыхымҭа «%S», %Sx%Sпиксел амоуп)	(Изображение «%S», %Sx%S пикселов)
(Асахьаҭыхымҭа «%S»)	(Изображение «%S»)
%S (аобект «%S»)	%S (объект «%S»)
(Аобект «%S»)	(Объект «%S»)
Асахьаҭыхымҭа «%S», агхақәуа хьамо,  аарԥшра ауӡом.	Изображение «%S» не может быть показано, так как содержит ошибки.
Амасштабҟаҵара (%S%%)	Масштабированное (%S%%)
Атип:	Тип:
Ахҳәааҟаҵара:	Описание:
Асахьа:	Информация:
Аизыҟазаашьа:	Отношение:
Ахы:	Заголовок:
Аимпорт аҟаза	Мастер импорта
Азырхиарақәа аимпоррт рзутәуп, агәылаҵақәа, ажурнал, ажәамаӡақәеи егьырҭь адаррақәеи рыҟнытә:	Импортировать настройки, закладки, журнал, пароли и другие данные из:
Агәылаҵақәа аимпорт рзутәуп ...нтә:	Импортировать закладки из:
Агәылаҵа змоу прграммак, ажурнал ма ажәамаӡақәа, ԥшааӡам.	Ни одной программы, содержащей закладки, журнал или пароли, не найдено.
Адыррақәеи архиарақәеи римпорт	Импорт настроек и данных
Аимпорт азы аобиект	Объекты для импорта
Аимпортзуразы аобиектқәа алашәх:	Выберите объекты для импортирования:
Агәылаҵақәа	Закладки
Афаил:	Файл:
Азеиԥш рдырра 	Общее уведомление
Аиқәырхара	Сохранение
Аиқәрхара аҟынтә:	Сохранение из:
аҟны	В:
Аартра аҟынтә:	Открытие из:
Аиқәырхара #1	Сохранение #1
Аҭагылазаашьа:	Состояние:
Иқәыныху аамҭа:	Затраченное время:
Аҭагалара анагӡара анеиҩсана аԥенџьер аҳмырклап.	Не закрывать окно после завершения загрузки.
Аҭаӡ аартра	Открыть папку
Аиқәырхара «%S»	Сохранение «%S»
«%S» аартра	Открытие «%S»
Ари азҵаара уаҳа аҳамҭалап.	Больше не задавать этот вопрос.
Афаил «%S» аартра ауӡом, избанзар иадҳәало ацхырааратә ацраԥшьы ыҟадӡам. Ашьақәыргыларақәа шәыԥсах.	Файл «%S» не может быть открыт, так как связанное с ним вспомогательное приложение не существует. Измените настройки.
Аҭагалара «%S»	Загрузка «%S»
Алхратә фаил	Выбор файла
Ихадоу	Основная
Авизуализациа ахкы:	Тип визуализации:
Ашәагаа:	Размер:
Аҵыхәтантәи аиҭакрақәа::	Последнее изменение:
Акодркра:	Кодировка:
Амультимедиа	Мультимедиа
Ашәагаақәа:	Размеры:
Ишԥа еқәырхатәу…	Сохранить как…
Амультимедиа азаахәаԥшра:	Предпросмотр мультимедиа:
Азин ҟаҵара	Разрешения
Ишыҟоу еиԥш	По умолчанию
...аза азинҟаҵара:	Разрешения для:
Асахьақәа рҭагалара	Загружать изображения
Ихәыҵыҵуа аԥенџьырқәа раартра	Открывать всплывающие окна
Cookies ашьақәыргыларақәа	Устанавливать Cookies
Ахкырбагақәа ма атемақәа шьақәыргылалатәуп	Устанавливать расширения или темы
Ари адаҟьа ахьчаразы аинформациа	Информация о защите этой страницы
Авеб-саит ахаҭара	Подлинность веб-сайта
Аԥшәма:	Владелец:
Ишьақәырӷәӷәоуп:	Подтверждено:
Ахатәреи Аҭоурыхи	Приватность и История
Ари авеб-саит ахь уаанӡа унеихьазма?	Посещал ли я этот веб-сайт ранее?
Ари асаит аинформациа (cookies) сара скомпиутер аҟны иҵәахтәума?	Хранит ли этот сайт информацию (cookies) на моём компьютере?
Cookies иахәаԥштәуп	Просмотреть Cookies
Ари авеб-саит азы иарбанзаалак ажәамаӡа сҵәахуазма?	Сохранял ли я для этого веб-сайта какие-либо пароли?
Иеиқәырхоу ажәамаӡақәа ирыхәаԥштәуп	Просмотреть сохранённые пароли
Атехникатә хәҭақәа	Технические детали
аҭагалара иаҿуп…	Изображение
Афонтә ҭыхымҭа	Фоновое изображение
Адыргаҷа	Значок
Аилахәра арежим	Режим совместимости
Астандартқәа ирықәшәо арежим	Режим соответствия стандартам
Ари авеб-саит ахаҭара иазкны аинформациа ыҟам	Информация о подлинности этого веб-сайта отсутствует.
Ахархәаҩ ихьӡ	Имя пользователя
Амаӡажәа.	Пароль
Аиҭакра	Изменить
Иқәҳарҟьап	Сбросить
Авеб-саит ахаҭара шьақәырӷәӷәоуп	Подлинность веб-сайта подтверждена
Аидҵара еилырганы ишифркым	Соединение не зашифровано
Шәара шәызхәаԥшуаз адаҟьазы Асаит %S аԥхьаразы иацхраауам.	Сайт %S не поддерживает шифрование для просматриваемой вами страницы.
Шифрда интернет ала идәықәҵоу адырра даҽа џьоукы ирымпаҵашәар ҟалоит анашьҭраан.	Информация, отправленная по Интернету без шифрования, может быть доступна другим во время передачи.
Амодул	Модуль
Амҩа	Путь
Ахҳәааҟаҵара	Описание
Ахьӡынҵа	Список
Иҭаӡахым агәлаҵақәа	Неподшитые закладки
Ахҵарақәа	Метки
Аплагинқәа рзы(plugins)	О плагинах (plugins)
Иқәыгыло аплагинқәа	Установленные плагины
Аплагниқәа ықәыгылам	Плагины не установлены
Афаил ахьӡ:	Имя файла:
MIME атип	Тип MIME
Асуфикскқәа	Суффиксы
Иаҿакәып	Включён
SSL прокси:	SSL
Аҟазшьақәа	Свойства…
Апринтер 	Описание принтера:
Апринтер	Принтер
Апринтер:	Принтер:
Апринтер ҿыгара адиапазон	Диапазон печати
Адаҟьақәа зегьы	Все страницы
Адаҟьақәа	Страницы
аҟынза	по
Иалкаау афрогмент	Выделенный фрагмент
Ақәҭыхқәа	Копии
Акопиақәа рхыԥхьаҿзара:	Число копий:
Афреимқәа апринтер аҿыгара	Печать фреймов
Аекранаҿ иаарԥшу	Отображаемых на экране
Иалкаау афреим	Выделенного фрейма
Афреимқәа зегьы хаз-хазы	Всех фреймов по отдельности
Аекранаҿ иаарԥшу	&Отображаемых на экране
Иалкаау афреим	Выделенного &фрейма
Афреимқәа зегьы хаз-хазы	&Всех фреймов по отдельности
Адаҟ. %1$d , %2$d аҟынтә	Стр. %1$d из %2$d
Афаил ахьӡ ыҟаӡам	Отсутствует имя файла
Шәара алышәхит «Печать: в файл», афаил ахьӡ амҭакәа!	Вы выбрали «Печать: в файл», но не задали имя файла!
Апринтер агха	Ошибка принтера
Аԥхьа алаԥшхгараан агха.	Ошибка предварительного просмотра
Апринтер аҿыгара аан апроблема цәырҵит. Апринтер, апринтера аҿыгара адҵа аднакылом.	Во время печати возникла проблема. Принтер не поддерживает команду печати.
Апринтер аҿыгара аан апроблема цәырҵит. Апринтерахь инашьҭыз аинструкциа нагӡам.	Во время печати возникла проблема. Инструкция, отправленная принтеру, не выполнена.
Апринтер аҿыгара аан апроблема цәырҵит. Принтеркгьи ԥшаам	Во время печати возникла проблема. Ни один принтер не найден.
Апринтер аҿыгараан апроблема цәырҵит. Апринтер ԥшаам.	Во время печати возникла проблема. Принтер не найден.
Апринтер аҿыгара аан апроблема цәырҵит. Апринтерахь анеирҭа амам.	Во время печати возникла проблема. Доступ к принтеру запрещён.
Апринтер аҿыгара аан апроблема цәырҵит. Аҽазышәара ыҟан, иашам апринтер атрибут арбара. 	Во время печати возникла проблема. Попытка указать недействительный атрибут принтера.
Апринтер аҿыгара аан апроблема цәырҵит. Апринтер рхьаӡам.	Во время печати возникла проблема. Принтер не готов.
Апринтер аҿыгара аан апроблема цәырҵит. Апринтераҿы ақьаад нҵәеит. 	Во время печати возникла проблема. В принтере закончилась бумага.
Апринтер аҿыгараан апроблема цәырҵит. Апринтер аҭагалара-алгаратә система агха.	Во время печати возникла проблема. Ошибка системы ввода-вывода принтера.
Апринтер аҿыгара аан апроблема цәырҵит. Аҭыҵратә фаил аартра амам.	Во время печати возникла проблема. Выходной файл не может быть открыт.
Анҭыҵратәи афаил апринтер аҿыгараан ....	Во время записи выходного файла печати возникла ошибка.
Аԥхьа алаԥшхгара архәаразы принтерк ахь анерҭа ҳамазароп.	Для использования предварительного просмотра должен быть доступен хотя бы один принтер.
Апринтер аҿыгара аан ҳазқәымгәыӷуаз апроблема цәырҵит. 	Во время печати возникла неожиданная проблема.
Апринтер аҿыгара аан апроблема цәырҵит. Апринтер аҿыгараз агәнкылара азхом.	Во время печати возникла проблема. Недостаточно памяти для печати.
Икаректым апринтер аҿгараантәи афункциақәа макьана инагӡам.  	Некоторые функции печати ещё не реализованы.
Анеишьа амам	Недоступно
Апринтер аҿыгара еԥырҟоуп ма ырхынҳәуп.	Печать прервана или отменена.
Апринтер аҿыгара аан елкаам агха ҟалеит.	Во время печати произошла неизвестная ошибка.
Адокумент апринтер аҿыгараан аҵыхәтәан агха.	Ошибка печати в конце документа.
Апринтер аҿыгараан агха, адаҟьа анҵәамҭаз.	Ошибка печати в конце страницы.
Адокумент аԥхьатәи алаԥшхгараан апринтер аҿыгара шәылшаӡом.	Вы не можете печатать документ во время его предварительного просмотра.
Апринтер аҿыгара аан апроблема цәырҵит, избанзар 	Во время печати возникла проблема, потому что печать на бумаге указанного размера не поддерживается вашим принтером.
Апринтер аҿыгара аан апроблема цәырҵит, избанзар иарбоу оринтациа шәпринтер аднакылом.	Во время печати возникла проблема, потому что печать с указанной ориентацией не поддерживается вашим принтером.
Апринтер аҿыгара аан апроблема цәырҵит, ибанзар шәпринтер иақәынаго аԥшхәытәқәа аднакылом.	Во время печати возникла проблема, потому что ваш принтер не поддерживает печать необходимых цветов.
Апринтер аҿыгара аан апроблема цәырҵит, избанзар апринтер аҿгаразы ирацәаны акопиақәа адышәҵеит.	Во время печати возникла проблема, потому что вы запросили печать слишком большого числа копий.
Апринтер аҿгара еиԥҟьеит. Апринтер адраивер шышьақәыргыло ҽеим	Во время печати возникла проблема. Драйвер принтера установлен некорректно.
Апринтер аҿгаратә аиҿцәажәара ...........	Отсутствует служба вызова диалога печати.
Апринтер аҿыгара ма аԥхьатәи алаԥшхгара залшом.	Не удалось произвести печать или предварительный просмотр этой страницы.
Апринтер аҿыгара аан апроблема цәырҵит, иарбоу арежим шәпринтер аднакылом.	Во время печати возникла проблема, так как указанный режим не поддерживается вашим принтером.
Абраузер залшом адокумент аҭагалараан апринтер аҿыгара.	Браузер не может печатать документ во время его загрузки.
Апринтер ҿыгаратә функциақәа макьана инагӡам.	Функции печати ещё не реализованы.
Иқәынаго апринтер ҿыгаратә модул ҭагалашьа амам. 	Требуемый модуль печати не может быть загружен.
Апринтер аҿыгара аан апроблема цәырҵит, избанзар иарбоу азин/ахаҭабзиара шәпринтер аднакылом.	Во время печати возникла проблема, потому что указанные разрешение/качество печати не поддерживаются вашим принтером.
Ҳзызнеиуа апринтерқәа ыҟам.	Нет доступных принтеров.
Апринтепр ашьақәырглақәа	Настройки принтера
Акьаад ашәагаа:	Размер бумаги:
Арежим:	Режим:
Азин/Ахаҭарабзиара:	Разрешение/Качество:
Апринтер аҿгаразы адҵа:	Команда печати:
Адҵа ахьӡ:	Имя задания:
Аԥшхәтәы:	Цвет:
Аԥшхәтәы	Цвет
Аԥшхәтәқәа реиужьра:	Пространство цветов:
Ашрифтқәа:	Шрифты:
Апринтер ахь ашрифтқәа ҭаҳгалома?	Загрузить шрифты на принтер?
АДӘЫ аҭбаара	Ширина поля
Аҩадантә:	Сверху:
Аладантә:	Снизу:
Арымарахтә:	Слева:
Арыӷьарантә	Справа:
Адаҟьа архиарақәа	Параметры страницы
Аформати аҟазшьақәыеи	Формат и свойства
Аформат	Формат
Аҭыԥп:	Ориентация:
Ашәҟәытәы	Книжная
Албомтә	Альбомная
Амасштаб:	Масштаб:
Адаҟьа аҭбаара аҟынӡа аиҵарӷәара	Сжать до ширины страницы
Аҵаԥшыхәытәы апринтер аҿыгара (аԥшыхәытәқәеи асахьақәуеи)	Печать фона (цвета и изображения)
АДӘқәеи аколантитулқәеи	Поля и колонтитулы
дуимқәа	дюймов
милиметра	миллиметров
Агәыҭала:	По центру:
Аҩадатәи аколантитул (арымарахьынтә)	Верхний колонтитул (слева)
Аҩадатә аколантитул(агәыҭала)	Верхний колонтитул (по центру)
Аҩадатә аколантитул(арӷьарахьынтә)	Верхний колонтитул (справа)
ҵаҟатәи аколантитул(арымарахьти)	Нижний колонтитул (слева)
Аладатәи аколантитул (агәҭала)	Нижний колонтитул (по центру)
Аладатәи аколантитул (арӷьарахьынтә)	Нижний колонтитул (справа)
\--иҭацәуп--	--пусто--
Ашьақәыргыла...	Настройка…
аҟынтә	из
Аԥхьатәи адаҟьа	Первая страница
Аҵыхәытәантәи адаҟьа	Последняя страница
Анеиҩстәи адаҟьа	Следующая страница
Аԥхьа инеуа адаҟьа	Предыдущая страница
Аԥхьатәи алаԥшхгара	Предварительный просмотр
Аԥхьатәи алаԥшхгаразы архьиара	Подготовка к предварительному просмотру…
Апринтер аҿыгара хыркәшоуп.	Печать завершена.
Аҭаара ажурнал	Журнал посещений
ахархәара аҿҳәара нцәаанаӡа	до истечения срока их действия
Иарктәуп	до закрытия мною &brandShortName;
ескьынагь аҵаара	спрашивать каждый раз
Ахатә дыррақәа	Личные данные
Уажә ирыцқьатәуп	Очистить сейчас
Аҭыҵра	Выход
«%2$S» адҵаалара ҟанаҵоит  ахархәаҩ ихьӡи имаӡажәеи шаҭахәы. Асаит иҳанаҳәои: «%1$S»	«%2$S» запрашивает имя пользователя и пароль. Сайт говорит: «%1$S»
Прокси «%2$S» адҵаалара ҟанаҵоит  ахархәаҩ ихьӡи имаӡажәеи шаҭахәы. Асаит иҳанаҳәои: «%1$S»	Прокси «%2$S» запрашивает имя пользователя и пароль. Сайт говорит: «%1$S»
%1$S азы ахархәаҩ ихьӡи имаӡажәеи ҭажәгал	Введите имя пользователя и пароль для %1$S
%1$S азы %2$S аҟны амаӡажәа ҭажәгал.	Введите пароль для %1$S на %2$S
Аҭыҵра ахьынтә (%S)	Выход из %S
Иҭыҵтәуп	&Выйти
Ихьчатәуп иҭыҵтәуп	&Сохранить и Выйти
Уашьҭантәи адәықәҵараан ишәҭахума  %S иахьчарц шәҭахума иаарту аԥенџьырқәеи агәылаҵақәеи.	Вы хотите, чтобы %S сохранил открытые окна и вкладки и восстановил их при следующем запуске?
Уашьҭантәи адәықәҵараан ишәҭахума  %S иахьчарц шәҭахума иаарту аԥенџьырқәеи агәылаҵақәеи?	Вы хотите, чтобы %S сохранил открытые вкладки и восстановил их при следующем запуске?
Ангилиа	Ангилья
Албаниа	Албания
Австриа	Австрия
Австралиа	Австралия
Аландтә о-ва	Аландские о-ва
Беларус	Беларусь
Кокостә (Килинг) о-ва	Кокосовые (Киилинг) о-ва
Африкантә-Агәыҭатәи республика	Центрально-Африканская республика
Китаи	Китай
Чештә республика	Чешская республика
џьибути	Джибути
Даниа	Дания
Доминикантә Республика	Доминиканская Республика
еквадор	Эквадор
Мраҭашәаратәи Сахара	Западная Сахара
Еритреиа	Эритрея
Фолклендтә (Малвинтә) о-ва	Фолклендские (Мальвинские) о-ва
Микронезиа	Микронезия
Великобританиа	Великобритания
Қырҭтәыла	Грузия
Афарнцызтә Гвиана	Французская Гвиана
Гамбиа	Гамбия
екваториалнаиа Гвинеиа	Экваториальная Гвинея
Грециа	Греция
Аладатә џьорџьиеи аладатә Сандвичевы о-ва	Южная Джорджия и Южные Сандвичевы о-ва
Гвинеиа-Бисау	Гвинея-Бисау
Гаиана	Гайана
о-ва Херд и Макдоналд	о-ва Херд и Макдональд
Израил	Израиль
о. Мен	о. Мэн
Индиа	Индия
Иамаика	Ямайка
Иорданиа	Иордания
Иапониа	Япония
Кениа	Кения
Камбоџьа	Камбоджа
Севернаиа Кореиа	Северная Корея
Казахсҭан	Казахстан
Сент-Лиусиа	Сент-Люсия
Либериа	Либерия
Ливиа	Ливия
Мианма	Мьянма
Аҩада Мариантә острова	Северные Марианские острова
Маврикии	Маврикий
Малдивы	Мальдивы
Новаиа Каледониа	Новая Каледония
Ниуе	Ниуэ
Новаиа Зеландиа	Новая Зеландия
Афранцузтә Полинезиа	Французская Полинезия
Папуа-Новаиа Гвинеиа	Папуа-Новая Гвинея
Пакисҭан	Пакистан
Сен-Пер и Микелон	Сен-Пьер и Микелон
Пуерто-Рико	Пуэрто-Рико
Парагваи	Парагвай
Реиунон	Реюньон
о-ва Свалбард и иан Меиен	о-ва Свалбард и Ян Мейен
Сириа	Сирия
о-ва Теркс и Каикос	о-ва Теркс и Кайкос
Афарнцызтә аладатә ҵакырақәа	Французские южные территории
Таџьикисҭан	Таджикистан
Туркменисҭан	Туркменистан
Танзаниа	Танзания
Ихәыҷу Тихоокеантә Ихароу острова (США)	Малые Тихоокеанские Отдаленные острова (США)
Уругваи	Уругвай
Виргинтщ о-ва (Великобританиа)	Виргинские о-ва (Великобритания)
Ветнам	Вьетнам
иемен	Йемен
Маиотт	Майотт
Замбиа	Замбия
Икорректым авеб-саит азы адырра аҭара…	Сообщить о некорректном веб-сайте…
Амцуратә веб-саит азы адырра аҭара…	Сообщить о мошенническом веб-сайте…
Абызшәа	Язык
Иҽеим авеб-саит аӡбахә аҳәара	Сообщить о некорректном веб-сайте
Аҽырмаӡара аполитика	Политика приватности
Ари амаруга иҳанаҳәоит авеб-саитқәа, иҽеимкәа &brandShortName; аҟны аус шыруа; ма &brandShortName; аҟны аусура мап шацәыркуа;. Ҳаԥхьаҟа ахархәаҩ из ы &brandShortName; ҳацхраауеит авеб-даҟьаҿ аусура арманшәаларазы;.Ҳшәыҳәоит шәаԥхьа анаҩстәи атекст, иеизгахо аинформациа ахархәара шаиуа, иҳашәҭарц шәҭахызар.	Этот инструмент позволяет сообщить нам о веб-сайтах, некорректно работающих в &brandShortName; или отказывающихся работать в &brandShortName;. Это поможет нам в будущем улучшить работу с веб-страницами для пользователей &brandShortName;. Пожалуйста прочтите следующий текст, чтобы узнать, как будет использоваться собираемая информация, если вы согласитесь нам её передать.
Ацҵаразы шәаԥхьа аҽыҵәахра аполитика.	Перед тем как продолжить, вам нужно прочесть политику приватности.
Абызшәа:	Язык:
Ахатә дыррақәа раныхра	Удаление личных данных
Анаҩстәи адыррақәа раныхра:	Удалить следующие данные:
Ашьақәыргылара...	Когда я прошу &brandShortName; удалить мои личные данные, он должен стереть:
Ажәамаӡақәа	Пароли
Агәыҽанҵара	Предупреждения безопасности
Интернет аҿы ааусураан, иалышәх ижәбарц ишәҭаху агәҽанҵарақәа 	Выберите предупреждения, которые вы хотите видеть при работе в Интернете
Ашәарҭадара агәҽанызаара	Предупреждения безопасности
Аҭыԥп:	Расположение:
(Хьӡыда)	(Без имени)
Агәылаҵа арктәуп	Закрыть вкладку
Адақьа ҿыцқәа аартлатәуп ...аҿы:	Открывать новые страницы в:
Ахалагаратә код: 	Исходный код: 
Ахыркәшара	Завершение
Агәынкыларҭатә ҭыԥ азхом	недостаточно памяти
Асинтаксистә агха	ошибка синтаксиса
Еилкаам агәаҭа	неопределённая сущность
Иаркым аҟәша CDATA	незакрытый раздел CDATA
адәныҟатәи аҵакахь ахьарԥш адулараан агха	ошибка обработки ссылки на внешнюю сущность
иавтаномым адокумент	неавтономный документ
асинтаксистә анализатор аҭагылазаашьа еилкаам	неопределённое состояние синтаксического анализатора
ахьӡқәа реиужьрақәакгьи апрефикс адҳәалара амамзароуп	префикс не должен быть связан с ни с одним из зарезервированных пространств имён
Ҳазыԥшуп: </%S>.	. Ожидается: </%S>.
