Аԥсадгьыл зцәыӡыз – зегь ицәыӡит.	Теяющий родину – теряет все.
Аԥсуа жәаԥҟа	Абхазская пословица
АԤХЬАЖӘА	ПРЕДИСЛОВИЕ
сабшак хәылбыҽхан сыҩны даакылсит Қарбеи Барчан.	субботним вечером ко мне домой зашел Карбей Барчан.
анкьа арҵаҩратә институт аҟны аҵара еицаҳҵон	Когда-то мы учились вместе в педагогическом институте 
ақыҭантәи  школ аҿы директорс ayс иуан	 работал директором сельской школы
Аха Қарбеи дыццакуан. 	Но Карбей спешил. 
Иҳаԥшааит	Мы нашли
Аибашьра аԥхьа иҩын, аха иахьагьы уи ажәит ҳәа узҳәо иҟам.	Написана перед войной, но и сейчас не устарела.
Қарбеи дцеит, ҩажәи жәеиза шықәса раахыс ан лшәындыҟәра иҭаҵәахыз абри апапка, наҟ-наҟ иара иазыԥшыз алахьынҵа сыламыс ианажьны	Карбей ушел, оставив на моей совести дальнейшую судьбу этой папки, тридцать один год пролежавшей в сундуке у матери
Анапҩыра хыстуеит ҳәа снапы ахьсыркьысаанӡа иаалырҟьаны иаасыԥгылаз аҭакԥхықәра сааимнадеит аӡә иакәында, ҩыџьа анышә иамоу рҿаԥхьа.	прежде чем я открыл папку, в этом было что-то отягощавшее меня чувством ответственности, теперь уже не перед одним, а перед двумя умершими.
ахы инаркны аҵыхәаҟынӡа иаразнак снахҟьеит. 	 я сразу прочел рукопись очень быстро, от начала до конца. 
аха нас акырынтә сеиҭазыхынҳәит.	но потом еще несколько  раз вернулся. 
Ари анапҩыра, иара аԥызҵаз илахьынҵа еиԥш, имариамызт.	Рукопись была не  проста, как и судьба ее автора.
Шәарах Кәаӡба хаҭала сара дсыздырӡомызт. 	Самого Шараха Квадзбу я не знал. 
аха аибашьра ҟалаанӡа акырынтә иӡбахә саҳахьан.	но до войны много слышал о нем.
Уи ҳаҵкыс хәышықәса деиҳабын. 	Он был на пять лет старше нас. 
арҵаҩратә техникум Аҟәа даналга, дцеит Ленинградҟа.	Окончив педагогический институт в Сухуме, уехал в Ленинград.
Ленинградтәи арҵаҩцәа еицҿакны Кәаӡба излаихцәажәоз ала, иааирԥшуазаарын агәырҵҟәыл ҟаимаҭ. 	Квадзба, по отзывам его ленинградских профессоров, был человеком незаурядных способностей. 
убри иабзоураны Шәарах иоузар акәхап, усҟантәи аамҭазы уарлашәарлада иҟамыз, наука мҩала аҳәаанырцәҟа Ҭырқәтәылаҟа. 	поэтому даже ездил в редкую по тем временам заграничную научную командировку в Турцию. 
жәаф шықәса рышьҭахь	через шестнадцать лет
1958 шықәсазы	 в 1958 году
Аҟәа иааҩит хараӡа Италиа, Черменате ҳәа изышьҭоу аҭыԥ иналганы, Комо аӡиа азааигәара	в Сухуми пришли сведения, что в далекой Италии, за окраиной местечка Черменате, недалеко от озера Комо
Иара иеиԥш алахьынҵа змаз реиҳараҩык реиԥш. 	как и большинство других людей со схожими судьбами. 
Италиа аҳәаа иахьазааигәаз	из ближайших к границам Италии
Данҭахаз арыцхә – ҩажәи ԥшьба апрель 1945 шықәса 	а дата гибели – двадцать четвертое апреля 1945 года 
шаҳаҭра ауеит аибашьра анҵәамҭахь инеиаанӡа дшеибашьуаз	свидетельствовала, что он сражался  до конца войны
ҩымчыбжьа заҵәык рыла дшахьымӡаз Аиааира мшы!	всего-навсего двух недель не дожив до Дня Победы!
Инапҩыра аҭоурых ҳалацәажәозар,	Что касается истории его рукописи,
фымз рыҩнуҵҟа акьыԥхь азырхиара сахьынӡаҿыз. 	за те полгода, что я готовил к печати.
Дцо даналага, абӷьыцқәа ааиқәыршәаны апапка инагәылеиҵеит. 	Уезжая, сложил листы в папку
апапка апортфель инҭеиҵеит	папку положил в портфель
иан длыҳәан, ацаԥха аалымихын, ашәындыҟәра аҵа апортфель нҭаргыланы. 	попросил у матери ключ от сундука, сам положил этот портфель на дно
инапала  ашәындыҟәра наиркит.	сам запер сундук.
ацаԥха иан иналыҭауа, ус лаиҳәеит:	Отдавая ключ матери, сказал ей: 
Абарҭ ақьаадқәа  сара схынҳәаанӡа бшәындыҟәра иҭаҵәахызааит.	Пусть эти бумаги лежат у тебя в сундуке до тех пор, пока я не вернусь.
Ҿылҭӡомызт.	Молчала.
Иҟалап, лыҷкәын дахьжыз лыблақәа рыла ианылымба, иҭахара агәра лзымгозҭгьы.	Может быть, так и не увидев могилы сына, продолжала не верить в его смерть.
Анс акә, арс акә, уи лыԥсы ахьынӡаҭаз, ашәындыҟәрахьтә апортфель цәырылгомызт	Во всяком случае, ни разу до самой кончины не достала портфель из сундука
Шәарах Кәаӡба инапҩыра хәышә инарықәгәыӷуа, иаҳа иҭырҳәыцааны иуҳәозар, ԥшьышәи ԥшьынҩажәи ҩба бӷьыц ыҟан	рукопись Шараха Квадзбы состояла почти из пятисот, точнее, четырехсот восьмидесяти двух листов. 
еивҵаԥсаны нбан ссала, анҵәамҭахь унаскьацыԥхьаӡа иаҳа ирццакны, аха аԥхьарагьы маншәаланы иҩын.	исписанных мелким, иногда, особенно ближе к концу, торопливым, но разборчивым почерком.
Анапҩыра агәҭахьшәа иагәылан ҩ-даҟьак машьынкала икьыԥхьыз. 	В середине рукописи были заложены две машинописные странички. 
Шә. Кәаӡба аибашьрахь дцаанӡатәи иавтобиографиа, арыцхәгьы аҵаҩын нанҳәа 1940 шықәса	датированные августом 1940 года, довоенной автобиографии Квадзбы. 
аха ани аублаақәа ирҷаныз абҩатә быкь ҳмузеи афондқәа зегьы иаарылукаартә иҟан, иагараангьы сахәаԥшхьан	но трубу эту убыхского происхождения, вещь редкостную, весьма заметную в фондах нашего музея я потом не раз видел
аха Шәарах Кәаӡба имҭаны абра ишаанагаз сыздырумызт.	только не знал, что это дар Шараха Квадзбы.
макьана изеилымкаакәа ишыҟоу акыр адгьыл ҭыԥхьыӡқәеи, иара убас аҭоурыхтә хаҿқәеи.	для него пока еще остаются невыясненными многие топонимические названия, а также некоторые исторические личности. 
Кавказтәи аибашьра анҵәамҭазы	В конце Кавказской войны
аублаақәа ишьҭырхыз анымшәара рхаҿы иааганы	столкнувшись с непримиримой позицией убыхов
аҳәынҭқар иеиҳабыра аублаақәа рԥызацәа иалырхырц	царское правительство предложило убыхским вождям выбрать
Аублаақәа рԥызацәа иалырхит, ҭоурыхла хара анаԥшра згыз амҩа	вожди убыхов выбрали то, которое исторически оказалось наиболее недальновидным. 
1864 шықәса рзы, рԥызацәа ирхьыԥшны	в 1864 году, следуя за своими вождями
уи ашьҭахь афырҭын бааԥс еимнарбӷьыжәааз аԥсаатә еиԥш, алахьынҵацәгьа иҟьаны ирыланаԥсеит Ааигәатәи Азиа атәылақәа жәпакы.	а вслед за этим, как ослабевших птиц, судьба разбросала их по многим странам Ближнего Востока.
Аублаа рбызшәеи рҭоурыхи кавказдырраҟны шьарда иаҵанакуеит	язык и история убыхов очень важны для  кавказоведения
исԥыхьашәеит зыхьыӡ дыру Европатәи кавказдырҩык иаацҳамҭа	мне попалось на глаза сообщение одного из видных европейских кавказоведов 
уи ишиҩуаз ала, аублаақәа ирхылҵыз, Ааигәатәи Азиа тәылак аҿы	который писал, что среди потомков убыхов, переселившихся в страны Ближнего Востока
ҩ-қыҭа паҿқәак ирыланхо ауааԥсыра рхыԥхьаӡарахьтә, аублаа бызшәала ицәажәо жәафҩык аанхеит.	в двух небольших соседних между собой селениях осталось еще шестнадцать человек, говоривших на убыхском языке.
АКТӘИ АШӘҞӘЫ	КНИГА ПЕРВАЯ
Аҽыуардын сахьаақәҵыз сгылоуп снаԥшы- ааԥшуа, схы ахьсырхара сзымдыруа.	Слезая с повозки,  стою, гляжу и не знаю, куда идти.
ашоурацәгьа маҷк аҟара ихҽхьан	Жара теперь чуть-чуть спала
аԥша ҟәанда, амҩақәа рҿы бла иамбо ҳәымсаг дуӡӡак еиԥш асаба ныԥхьанаҳәҳәон.	теплый ветер, словно огромный невидимый веник, метет пыль по дороге.
Арыӷьарахь ихараны иубарҭоуп ақыҭа	Справа вдали виднеется деревня
Сгылоуп, иџьасшьо сахәаԥшуеит ари сасзы итәыму адгьыл.	Стою и с удивлением смотрю на эту чужую мне землю.
Абри анышә аума рыбаҩқәа згәыҵаҳәҳәоу?	 в этой земле лежат их кости?
рацәак даумкәа хаҵак	Не очень высокий мужчина 
Бирам иакәзаап.	это все-таки Бирам. 
– Аброуп иара иҩны.	– Здесь его дом.
– Уахь акәым - арахь.	– Не там – тут.
ҩаԥхьа инапы наирхеит	Он снова показывает пальцем
убасҟан ауп иангәасҭа уи аҩны.	Тогда я заметил  этот дом.
- Ара уԥшыз.	– жди здесь.
Заурҟан аҩны дыҟазар еилыскаап	Я узнаю, дома ли Зауркан.
Шәышықәса!	Сто лет!
Дыҟамзар ҳәа сшәоит, уажәшьҭа ила ҳгәанаҭахьазаарын.	– боюсь, что сейчас его нет дома, его собака б уже нас заметила.
Иажәа алгаха имҭакәа, лак аахықәгылан, ашра иналагеит	Но не успевает он этого сказать, как выскакивает собака и начинает лаять
Ала ашра иааҟәыҵын, сара сахь иааԥшуеит.	Собака перестала лаять, и смотрит на меня.
Иаҵанакӡозеи абызшәаҵара анауказы иареи сареи ҳаиқәшәара?	Что значит для языковедения моя встреча с ним ?
Абар Бирамгьы	 вот и Бирам
уажәоуп иангәасҭа, ишьапы ӷәӷәала иҵишьуазаап.	Только сейчас я заметил, оказывается, он сильно хромает.
– Заурҟан аҩны дыҟоуп.	– Зауркан дома.
уажәы дықәиоуп	Сейчас он лежит 
иԥсы ишьоит	Он отдыхает 
уажәы дгылоит, уидикылоит	сейчас встанет и примет тебя
иҳәоит иара	говорит он
Анышә мардуан ала ҳаҩхалан, аҩны аԥхьа ҳаагылт.	Мы поднялись  по земляным ступенькам и остановились перед домом. 
Руак ашьапаҿы атәарҭа адҟаҵалоуп, убра ҳнықәтәеит Бирами сареи	Под одним из них стоит скамейка, и мы с Бирамом присаживаемся на нее
Исыдуҵаз узаазгеит ҳәа иасҳәеит, аха ҿимҭит.	Я сказал ему, что принес то, что он велел, но он ничего не ответил.
бжеиҳан аҭак ҟаиҵом.	Он часто ничего не отвечает.
Саанхеит сымацара	Я остался один
– Бзиала уаабеит!	– Добро пожаловать!
– иҳәеит уи ҭырқә бызшәала	– говорит он мне по-турецки
дааҭгыланы, иарӷьа напы игәышԥы аҟынӡа ишьҭыхуа.	останавливаясь и поднимая  правую руку до груди. 
– Бзиара убааит!	– Добрый день!
сҳәеит саргьы ҭырқә бызшәала.	Отвечаю я по-турецки 
– Иахьа цәгьаӡа ишоуран.	– Небывалая жара стояла сегодня.
– Аа, иахьа даара ишоуран! - сҳәеит саргьы.	– Да, было очень жарко, – сказал я тоже. 
аҭесԥыҳә аимхәыцқәа ахьеиҿаԥсоз абжьы саҳауан.	я слышу пощелкивание четок.
«Сышԥалагари?	«Как начать?
– схәыцуеит сара.	– думаю я.
– Заҟа шықәса шәхыҵуеи?	– Сколько вам лет?
– Сықәразы акәхап узааиз?	– Наверное, ты пришел  ко мне из-за моего возраста?
уаҳа уззаарыз ҳәа акгьы сымам.	Ничего другого,что привело бы тебя ко мне, у меня нет. 
–Аброума шәара шәахьиз?	– Вы родились здесь?
– сҵаауеит сара	– спрашиваю я
– Сара сахьиз аракәӡам, ихароуп!– иҳәеит уи.	– я родился не здесь, очень далеко! - сказал он. 
– Уара уабатәида, уабантәаауеи?	– откуда ты? И откуда приехал?
Асовет Еидгылантәи.	Из Советского Союза.
– Ишԥа?	– Как?
– даҽазнык дҵааит уи, илымҳа инапы надкыланы.	– переспрашивает он, поднося ладонь к уху.
– Асовет Еидгыла.	– Советский Союз.
Урыстәыла.	Россия.
Кавказ.	Кавказ.
Аԥсны.	Абхазия.
Кавказ.	Кавказ.
Аԥсны.	Абхазия.
– Ааи, Кавказтәуп, Аԥснытәуп сара.	– Да, я с Кавказа, из Абхазии.
– Узмилаҭда уара?	– Какой ты национальности? 
дааццакны ибжьы неиҵихит аҭаҳмада, исымҳәар ҳәа дшәозшәа.	спрашивает он поспешно, так, словно боится, что я не скажу. 
– Саԥсыуоуп сара, Аԥснынтәи саауеит!	– Я абхазец, я из Абхазии приехал.
– Уаԥсыуоума?	– Ты абхазец?
О, Аллаҳҭаала, шьарда зымчу, изакәызеи исаҳауа!	О Аллах всемогущий, что я слышу!
–	–
абарҭ ажәақәа аҭаҳмада иҳәеит ицқьакәакәараӡа аԥсышәала	Старик произносит эти слова на чистом абхазском языке
ажҩан ахь инапқәа иҩарханы.	подняв руки к небу.
– Ааи, саԥсыуоуп, Аԥснынтәи саауеит!– еиҭасҳәеит сара, аха ожәы аԥсышәала.	– Да, я абхазец, я приехал из Абхазии! – еще раз повторяю я, но теперь уже по-абхазски.
– О, изакә гәырӷьароузеи иаалырҟьаны исзааугаз!	– О, какую радость принес ты мне!
заҟа ҵуазеи аԥсыуак дсымбеижьҭеи.	Сколько лет я не видел ни одного абхазца.
иԥсыз ауаа гылан адәы иқәлар аха аԥсышәак саҳауеит ҳәа сыҟамызт.	скорей мертвецы воскреснут, чем я еще раз услышу абхазскую речь.
сшуцәтәымуаҩым удыруазааит!	– Знай, что я не чужой тебе!
сан разҟыцәгьа даԥсыуа ҭыԥҳан	Моя несчастная мать была абхазкой
Ҵабалтәын, Шаҭаа дырҭыԥҳан.	из рода Шат-Ипа, из Цебельды.
Иухьӡузеи?	Как твое имя?
Утәа, утәа, агылара уара иуаҭәам!	Садись, садись, тебе не положено стоять!
Уахаҵәҟьа иаасықәшәан сыԥсыргьы	Если я сегодня же ночью умру
иҽизеиқәкуамызт аҭаҳмада	Старик никак не мог успокоиться
дааиуан абас ҳәауа еиҭаҳәауа: – Асас ду дысҭоуп иахьа.	Ходил раз за разом повторяя все одно и то же: – У меня сегодня большой гость.
сахьиз, сахьааӡаз адгьыл аҟынтәи дааит, сибарц дааит.	Он приехал ко мне оттуда, где я родился, чтобы увидеть меня.
аублаақәа асас идкылашьагьы рдыруан	убыхи знали, как принимать гостей
амца ахы неихәлеиҵеит	разжигает огонь
Аҽҳәа нырцә-аарцә аҟәардә лаҟәқәа гылоуп	У очага несколько низких скамеек
аҭӡамц ацәардаӷәы икҿоуп	у стены нары
Зегьынџьара ицқьакәакәараӡа еилыргоуп.	Везде чистота.
Аха дарбан?	Но кто?
Ус дхынҳәуеит гәыдкылак афархь иманы.	Он возвращается с охапкой хвороста.
– Ус ауп, дад Шәарах, ус ауп!	– Вот так, мой дорогой Шарах, вот так!
аԥсшәа схамышҭӡеит	я не забыл абхазский язык
Сан ислырҵеит лбызшәа	моя мать научила меня своему языку
Ус даацәырҵуеит иара	Но вот появляется и он сам
уажәы еиқәаҵәа маҭәала деилаҳәоуп	Теперь он в черной одежде 
ҳаракуп	высокая 
Иахьа сара исзынханы иҟоуп	Сегодня она у меня
Абри еиԥш абыкь, аублаатәыла ҳанынхоз, сабгьы иман	Когда мы жили в стране убыхов, у моего отца была такая же труба
зегьы ирдыруан Ҳамырза асасцәа шиҭаз.	все знали, что к Хамирзе приехали гости.
Нас, иахагьы игароуп абри абыкь абжьы	Так пусть же эта труба протрубит и в эту ночь
аублаақәа ирдырроуп асас дахь,  саншьа бзиахә дшысҭоу!	 убыхи должны узнать , что у меня в гостях близкий человек, мой дядя по матери!
абыкь иманы дындәылҵит аҭаҳмада.	старик выходит с трубой в руках.
саргьы снаишьҭалеит, уамашәа ибо.	Я в недоумении выхожу вслед за ним.
Аҵла  днараҩсны, ахықә дықәгыланы, абыкь асра далагеит.	Миновав деревья, он останавливается над обрывом и начинает трубить.
Ицоит урҭ абыжьқәа аҩны ахыбра иахылҵуаз алҩаҵә еиԥш	Эти звуки поднимаются, как дым над крышей дома 
иҵегьы иргәаҟганы изымгозеи уи абжьы	почему эта труба не закричит еще жалобнее 
изаҳауа зегьы аҽыр-ҽырҳәа иарҵәыуартә. 	так, чтобы заплакали все, кто ее услышит.
Игоит аҵыхәтәантәи аублаақәа рбыкь абжьы	Трубит последняя труба убыхов
аҵыхәтәантәи аублаақәа рбыкь еиқәтәеит	Последняя труба убыхов замолкла
аха аҵыхәтәантәи амца еиқәуп макьана.	а последний очаг пока еще горит.
аха, суҳәоит, иахьа уԥсы шьа	но прошу тебя, сегодня отдохни
– Утәа, дад, утәа, уи урҭқәа издырӡом, -  иҳәеит Заурҟан.	– Садись, дад, садись, он не знает такое, – говорит Зауркан.
Зны-зынла Заурҟан ҭырқә бызшәала дхәыҭхәыҭуа ажәақәак наиеиҳәоит	Иногда он говорит Зауркану что-то по-турецки
дҩагылоит Заурҟан	Зауркан поднимается
Нас ауада агәҭа даагылан, усгьы ҿааиҭит:	Потом остановился в  середине комнаты и сказал:
– Аҳы, дадраа ахьырԥар	– А ну, молодые люди
Адәахьы илашьцоуп иҭынчроуп.	На дворе темно и тихо.
нас дааскьан, аҵла даамҵагылеит	Потом он подходит к дереву
инапы накәыршаны: – Ибуазеи, сан, былахь зеиқәузеи иахьа?	и, обхватив рукою: – Моя мать, почему ты так грустна сегодня?
Исгәаламшәои, ҳара ианаҳмаҳауаз, башьцәа гәхьааганы ԥсышәала амыткәма шыбҳәоз.	Я ведь помню, как ты тайком от причитала по-абхазски о своих оставленных братьях.
Бара дбашьахаҭамзаргьы, даԥсыуами.	Пусть он не твой кровный брат, но он все же абхазец.
биацәажәа, издыруада, башьцәа рхабарк беиҳәар.	Поговори с ним, кто знает, может быть, он что-нибудь знает о твоих братьях.
исгәалашәоит, ԥсыуак ҳаҩны данымҩахыҵлак	Я помню, как, если к нам приезжал абхазец
данцозгьы	И когда он уходил 
Мзымҭа	Мзымта
 ҳасас, Шәарах Кәаӡба	Наш гость, Шарах Квадзба
аҩныҟа дхынҳәит Заурҟан	Зауркан вернулся домой
ибжьы ҩеиҵыхны ҿааиҭит:	и возвышая голос сказал:
нас дықәҵәиаауа ацәажәара дналагеит аублаа бызшәала	Он вдруг начинает говорить на убыхском языке
теориала аҵара сыҿын акәымзар, уажәада исмаҳац уи абызшәа.	я теоретически изучал его, но еще никогда не слышал.
саигәа дгылан шәышықәса зхыҵуа ауаҩы аԥсцәа драцәажәо.	рядом со мной столетний человек разговаривает с мертвецами.
Аҩны аԥхьа Бирам ҳнапқәа ааҳирӡәӡәеит.	Бирам на пороге дает нам помыть руки.
– Нарчоу, итәараны иҟаз зегьы тәама?	– Нарчоу,все ли, кому положено сесть, сели?
иахьа иаҳҭоу ҳасас иаҟара амчра змоу даҽаӡәы ҳара ҳаҩны дымҩахыҵран дыҟам.	Сегодня у нас с вами такой почетный гость, наверно, в наш дом уже никогда не зайдет никто дороже его!
Уи даншьоуп	Он  дядя 
Заурҟан дгылоуп, ихы ҩышьҭыхны	Зауркан стоит с поднятой головой.
сихәаԥшуеит аҭаҳмада	Я смотрю на старика
алҩаҵә рыхҟьо акәаци абысҭеи збоит	Я вижу дымящееся жареное мясо и мамалыгу
Изҳәада аублаа уаҳа иҟам?	Кто сказал, что убыхи уже не существуют?
абар дара тәоуп, рыбызшәа саҳауеит...	Вот они сидят, я слышу их язык...
Аԥшәма  игәаԥхарала, ачара толбашьс иалху	по предложению хозяина выбранный тамадой
Саԥхьа дтәоуп, ибӷа аҭӡывара инкыдҵашәа.	Он сидит напротив меня, прислонившись спиной к стене.
Заурҟан ҿиҭуам.	Зауркан молчит.
Акаҳуа ыжәны ҳаналга	когда мы допили кофе
ашьшьыҳәа дҩагылеит ус сеиҳәеит:	медленно поднялся и сказал мне: 
– Дад, Шәарах,уахала уаҳа усыргәаҟуам.	– Дад Шарах, я не побеспокою тебя больше этой ночью.
уааԥсамкәан уҟам	Ты устал 
ушьҭал, уԥсы шьа.	ложись и отдохни.
инапы нақәикит санааҩналаз аахыс сылаԥш иҵашәаз, абамба хыза зныршәлаз ашьҭаларҭа.	Он показывает мне рукой на тот топчан с ватным одеялом, который я заметил сразу же, как только вошел. 
–Цәамҭхаа уоуааит,	– Спокойной ночи,
макьана имгылац рацәаҩуп	Многие еще не встали 
Бирам аҭаҳмада дхынҳәаанӡа сиарҭа ахьыҟаз сирбеит.	 Бирам, пока старик не вернулся, показал мне, где моя кровать.
Уи ауха лацәааихьшь сзыҟамҵеит.	В ту ночь я так и не заснул.
Аҭаҳмада ишьҭыбжь саҳауан	Я слышал шаги старика 
ихы дацәажәоит	разговаривает сам с собой
адәы днықәлоит, аҩны деиҭааҩналоит.	то бродит по двору, то заходит в дом
Ианаацәылаша, ихы нықәиҵеит	А когда рассвело, он лег 
аха сара уажәшьҭа сзыцәомызт	Но я уже не мог уснуть 
сыблокнот счамадан иааҭыхны аҩра сналагеит	я вынул из чемодана свой блокнот и начал писать 
Аха ибашазаарын сгәыҩрақәа.	Но опасения мои были напрасны.
иара ихала сара сҟнытә иуаҳарц иуҭахузеи ҳәа дсазҵааит.	он сам спросил у меня, что я хочу услышать от него.
ианиасҳәа дызнысыз иԥсҭазаара аҭоурых саҳарц шысҭаху	когда я сказал ему, что хочу услышать от него историю его жизни
избанзар, иара ида уи абызшәа здыруа уаҳа уаҩ дшыҟам	Потому что, больше нет никого кто знает этот язык, кроме него 
 ихы ааирҵысит.	Он кивнул.
Аха адырҩаҽны инаркны, ҳаидшылан ҳус ҳаҿын,	Но уже на следующий день мы взялись с ним за дело,
мызкы инеиҳаны, инҭырҳәцааны иуҳәозар, 34 мшы 	больше месяца, а точнее, 34 дня 
Бирам мышкы знык, еиҳарак ҩынтә дааиуан	Бирам приходил один, но чаще два раза в день 
иҳазхаша афатә ҳзааигон. 	приносил нам еду, которой мы вполне обходились.
Иамазма иара аублаа бызшәа ахатәы диалектқәа?	имел ли убыхский язык свои диалекты?
Заурҟан Шәача аӡиас амшын иахьалалоз дынхон	Зауркан жил у устья реки Сочи
уи Аублаатәыла агәҭа акәын	Это было  центром края убыхов
аҭаҳмада шьҭалара данцалак, ҳаицәажәараан сызхьымӡаз рынҵара сналагон	когда старик укладывался спать, я дописывал то, чего не успел записать во время беседы
зны-зынлагьы иааркьаҿӡаны, уашьҭан исхамышҭырц азы згәаҭақәакгьы ныҟасҵон.	 в некоторых случаях коротко, просто чтоб не забыть, делал заметки.
Аха хра зланы иҟаз,  Заурҟан иажәабжьқәа ракәын.	Но главным, конечно, были рассказа Зауркана 
АҨНЫ ҲАНЫҞАЗ	Когда мы были дома
 уан узхылҵыз духашҭраҳа. 	как ты  не способен забыть свою мать.
Мраҭашәарахь аедыгьқәа ҳгәылацәан, мрагыларахь – аԥсуаа.	На западе  нашими соседями были  адыгейцы, на востоке - абхазцы.
Аублаа бызшәа уеизгьы схатәы бызшәа акәын	Убыхский язык итак был мои родным языком
санҩыҵшәа инаркны, иара саҳауан аҩнгьы , ҳаҩнаҭа анҭыҵгьы.	с самого детства и у нас дома, и вокруг дома я слышал его. 
Исгәалашәоит	Помню
ачарыц зҭаз аҳаҭа	бурдюк, полный зерна
Исгәалашәоит, зны 	Один раз, помню
дааҭгыланы  ислырбеит, ашышкамсқәа 	она остановилась и показала на муравьев
– Арҭ ныҟәара амҩа иқәуп. 	– они идут в поход.
 аха уара иулшару?	Но сможешь ли ты?
– Ишԥасылымшои, уажәы ибсырбап!	–Как не смогу, сейчас покажу! 
– сҳәан, сшьапы ҩышьҭысхит, ашышкамсқәа снарыӷрагыларц	– сказал я и поднял ногу, чтобы наступить на муравьев
аха санду саанылкылеит	 но моя бабушка остановила меня
Ашышкамсқәа ушыриаауа сурбарц аума иуҭаху?	Хочешь показать мне, что ты победишь муравьев?
Зны-зынлагьы иҟалалоит убас, дхәыҷны, дыԥсыҽны, арахь ахшыҩ ду иманы.	Ведь иногда самый маленький и слабый бывает самый умный.
санду исалҳәеит   лакәк.	Моя бабушка рассказала мне сказку.
Зны изгәамҭаӡакәа шышкамск днаӷрагылт	Однажды, он нечаянно наступил на муравья
– Уабатәи уаҩагоу, ушьапы ахьургыло узымдыруа амҩа иану?	– Какой это дурак идет, не глядя под ноги?
агәы нырханы ицәажәеит ашышкамс	Сказал муравей, рассердившись
– Уӡарагьы ас изпоузеи? 	– А почему у тебя такая тонкая талия?
– шықәсык заҟа узыфарызеи?	– Сколько ты сможешь съесть за год?
 Иаабап	Посмотрим

иҳәеит  ауаҩы	сказал человек
ашышкамс чарыцк намҵаиршәит	бросил муравью  зерно пшеницы
Шықәсык ниасит	Прошел год
акәалаԥ ааиртит	он открыл коробочку
ашышкамс чарыцбжак ауп иафаз.	муравей съел  только ползерна.
– дҵааит ауаҩы. 	– спросил человек.
Сан 	Моя мать
ишуасҳәаз еиҧш	как я уже говорил тебе
даԥсыуа ҭыԥҳан	была абхазкой
Ҵабалтәи Шаҭаа ирылҵыз 	из Цебельды, из рода Шат-Ипа
Санхәыҷыз	Когда я был маленьким 
саныҩеидас	когда я стал подростком
саншьцәа	Братья моей мамы 
Ара сырзыӡырҩуан Нарҭаа рлакәқәа	Здесь я слушал сказания о нартах
Абрыскьыл фырхаҵа иажәабжьи	И сказание о герое Абрскиле 
уара иуҳәо ииашаҵәҟьазаргьы, сара сзы иҵабыргым.	даже если то, что  ты говоришь правда, для меня это неправда.
зегьакоуп	все равно
ацәажәара иаҿын 	 разговаривали
узеилкаама уара?	Ты понял ?
Иара	Он
аӡыршьҭра	Русло 
ианааҭабо	Когда засохнет 
усҟан	Тогда 
абжьгьы	И звук 
урымҵагылазар	Если ты стоишь под ними 
иумаҳаӡеи урҭ еибырҳәоз?	Ты не услышал о чем они говорили? 
Зышықәсан 	в тот год
аӡын гәҭаны 	в середине зимы
ара	Здесь 
аԥсаатәқәа	Птицы 
Иумаҳаӡеи, нас, рашәақәа зларҳәо рыбызшәа?	Разве не услышал ты язык их, которым они поют свои песни? 
Maп, дад Шәарах	Нет,дорогой Шарах
уара угәы ишаанаго еиԥш	как тебе кажется
ус иаармариан абызшәа бжьаӡуам	язык не умирает так просто
избанзар	потому что
иҭаҵәахуп	Спрятаны 
уи адагьы	Кроме этого 
ауаҩ	Человек 
ибз анҵәамҭаҿы	На кончике его языка 
Аӡы, адгьыл, ахаҳәқәа	Вода, земля, камни
Сызхылҵыз нхацәан.	Мои предки  были крестьянами.
Сабду сихьӡаанӡа дыԥсхьан	Мой дед умер до моего рождения 
дыҟан	Был 
исарҳәон	мне рассказывали
аамсҭак иҿы	у дворянина
убри алагьы иҭаацәа ныҟәигон	И этим кормил семью 
Саб, Ҳамырза, адгьылқәаарыхра напаиркит. 	мой отец, Хамирза, стал земледельцем.
Ааишьа заҵәык хаҵа дцахьан	только Айша была замужем 
 Шьхагәара ҳаман	У нас были улья 
Аџьықәреи	Кукуруза 
ацхеи ацәеи	мед и воск
 џьыкаки, сапынки, ашәақьхәшәи ааҳхәон. 	покупали  соль, мыло,  порох.
Аарҩареи аӡысаамҭеи аныҟаз	Когда бывала засуха и сильные дожди 
саби сареи, сашьаеиҵбы Мата аҩны дааныжьны	Я и отец, оставив моего младшего брата Мату дома
Шәача аӡиас аԥсҭахьы шыцԥҟара ҳҩаскьалон.	уходили по реке Сочи вверх по течению рубить самшит. 
аамсҭцәа рыхшара ааӡара анхацәа иргон.	крестьяне брали на воспитание детей из дворянского рода.
иара	Он
ҳара	Мы 
аҭаацәа	Семья 
ҳадагьы	Кроме нас 
зегьы	Все 
хәыԥҳас дрыԥхьаӡон.	Считали его молочным братом. 
Иман адгьыл	У него была земля
Абна 	Лес
иара убас	Также
акакан, ацха, аҩы	орехи, мед, вино
дасу илшоз. 	кто что мог.
Аублаатәи аамсҭа зегь раԥхьаӡагьы – деибашьҩын. 	Убыхский дворянин в первую очередь - был воином.  
иахьеи уахеи 	днем и ночью 
иҽи	Его конь 
икәадыри	Его седло 
иабџьар	Его оружие
 Аҩны иман  амаҵуцәа.	дома у него были  слуги. 
Саб Ҳамырза 	Мой отец Хамирза
Зны-зынла сылацәа анаахызҩалак 	Иногда, когда закрываю глаза
саԥхьа	Передо мной 
Аукы, лыхцәы хьаԥшшәыла. 	высокая, волосы ее каштанового цвета.  
 Аха ҳаԥхьа ишьҭазаарын алахьынҵа еиқәаҵәа.	Но впереди нас ждала страшная судьба.
Ақәылара	Набег 
ҳцахьан	Ходили 
Ҩынтә-хынтә	Два-три раза 
Ааи, дад Шәарах, уи аамҭа цәгьан!	Да, дорогой Шарах, это было тяжелое время!
Уи аԥсы иабаихәарҭоу.	мертвому это чем поможет.
Ус акәӡами	Не так ли 
сара сажәымҭагьы 	И моя старость 
 Сабгьы, сашьагьы, саргьы абџьар шьҭаҳхит	И отец, и брат, и я взялись за оружие
џьара	Где-то 
аҵыхәтәанынӡагьы	И до конца 
Аҵабырг ҳҳәозар	Если  сказать правду
Аублаатәылан ахаангьы ҭынчрамызт. 	в стране убыхов никогда не было спокойствия.  
ииҳәоз	То, что он говорил 
даамсҭаз	Пусть дворянин 
дынхаҩыз	дынхаҩыз
аибашьцәа зегьы рзы изакәанын. 	Для всех воинов было законом. 
иԥиҵәон аҿҳәара	он назначал срок
абыкь	Труба 
абжьы	Звук
ҲАЏЬЫ БЫРЗЫҚЬ КЬАРАНТЫХӘ	Хаджи Берзек Керантух
Аублаақәа  драԥгылан  Ҳаџьы Адагәа-иԥа	Хаджи Берзек, сын Адагвы, был предводителем убыхов. 
аха чарҳәаҩык иара изыҳәан дҟамлеит.	Однако ни одного изменника  не было. 
Ашьҭахь, ихатә гәаԥхарала уи ишьҭеиҵеит аублаа жәлар рԥызара.	И в конце он сложил с себя обязанности руководителя убыхов по собственной воле.
аимакра	Спор 
аибашьра ду аԥхьа аҳәынҭқар иеинралцәа дырнаалеит	 до войны он помирился с генералами царя
ауалафахәгьы ирҭеит. 	И зарплату дали. 
ачынгьы	И чин
аублаақәа ҳлахьынҵа усҵәҟьа имитәымхаргьы.	может бы судьба убыхов не была бы такой кошмарной. 
ҳара	Мы 
аибашьра	Война 
издыруада	Кто знает 
Ақыҭақәа рҿы 	В деревнях 
амулацәа	Муллы
 ҳара ҳашәзааит наӡаӡа	мы пришли к вам навсегда
шәышьхақәа 	ваши горы
асулҭан ду 	Великий султан 
абираҟ! 	Флаг! 
изаҵәу	Единственный 
аҳәынҭқар дышидгылаз даанхеит	как и был, остался на стороне царя
Ҳаџьы Кьарантыхә Асулҭан дидгылеит. 	Хаджи Керантух стал на сторону султана.
Уи шьахәла еиликаауан ҳара ҳар рхада Ҳаџьы Кьарантыхәгьы.	Хорошо понимал это и предводитель нашей армии Хаджи Керантух.
 иҵӡозеи уиаахыс!	сколько же прошло с тех пор!
Адунеи заҟаџьара аҽеиҭанакхьоузеи!	сколько раз все менялось в этом  мире!
Ҳқыҭақәа иаарылаҩит ажәабжь шьахәк. 	по нашим селениям пронеслась хорошая весть. 
аурысқәа аинаалара рҽазыркит	русские хотят помириться. 
Аԥснытәи аҳ Ҳамыҭбеи Чачба	князь Абхазии Хамутбей Чачба.
аублаақәа рааӡамҭа	воспитанник убыхов
 дыбжьаҟазоит	Посредничает 
Бзиа ибон уи мыцхәы абла ахыԥшылара. 	Он слишком любил смотреть человеку в глаза.  
Аублаа хьырԥар аӡәырҩы реиԥш	Как и многие молодые убыхи
Ҳаџьы Кьарантыхә ихаҵарақәеи, ихьӡ-иԥшеи 	слава и храбрость Хаджи Керантуха
Убасҟак бзиа дызбон убри ахаҵа	Я так любил этого мужчину
иара изын ахымҩас кәалаауа иааиуазар сара  инаԥыскылар сылшон сгәышԥы. 	всегда был готов преградить своим телом дорогу каждой пущенной в него пуле. 
Еҳ, аҷкәынра!	Ох, молодость!
– Саҳаҭқьери шәааиԥхь! 	– Позовите Сахаткери!
иҳәеит иара, ажәҩан иблақәа шалаҟацаз, дымхьаҳәкәа.	сказал он, продолжая глядеть в небо и не оборачиваясь.
Аибашьцәа рыжәпара дҩалсны  иаԥхьа даагылт Саҳаҭқьери. 	протиснувшись сквозь воинов, перед ним встал Сахаткери. 
Бџьар иҟәнымызт уи аӡәк.	Он единственный был без оружия.
– Измаанахарызеи ари?	– Что это может значить?
– Ари бзиарак иатәым!	– Это к несчастью!
Убри аҽны адагьы абас дааигәаны еинралк дсымбацызт. 	Я никогда до этого не видел так близко ни одного генерала. 
Уи, сыжәлар рлахьынҵа зыӡбауаз мшын. 	Это был день, который решал судьбу моего народа.
Аинрал	Генерал 
маҷк	Немного 
уҿы	Твой рот 
уцәажәалар ухәҭоуп. 	Тебе положено разговаривать. 
иҳәеит Кьарантыхә. 	сказал Хаджи Керантух. 
 сара ушәарыцалақәа саарымцеит. 	меня не пригнали твои охотничьи собаки.
сыԥсадгьыл сшьапы ықәгылоуп	Я стою на своей земле
ашьамҭлаҳәқәа сышьам	Я не в кандалах
сабџьар 	Мое оружие 
аха аҭырџьман еиҭеигаанӡа аинрал дыԥшын. 	но генерал ждал, пока переводчик переведет. 
 – Урҭқәа рҿгьы уаанымгылт уара!	– Но ты и на этом не остановился! 
Ԥыхьаеиԥш уажәгьы уиқәгәыӷуеит асулҭан. 	Ты как и раньше надеешься на султана.
ҳара иаадыруеит 	Мы знаем
уи иахьтә ушазԥшу арратә цхыраара	что ты ждешь от него военной помощи
адунеи аҿы	В мире 
даҽа 	Другой 
агәра ганы ушыҟазгьы	Хоть ты и верил 
дузымхеит	Тебе его не хватило 
Европатәи агазеҭқәа рҿы уи ианын. 	Об этом писали в европейских газетах. 
Уажәааигәаӡа Аҟәа итәоу англыз консул ашәҟәы изуҩыз ҳара иаҳԥыхьашәеит. 	К нам попало письмо, которое ты  недавно отправил английскому консулу в Сухуме. 
ара иҟоуп. 	Оно здесь. 
аԥсахра ада даҽак узахьыӡҵом уара ухымҩаԥгашьа!	Я не нахожу для твоих поступков другого слова, как измена!
– Ииашаҵәҟьаны сыԥсахыҩхон, Кавказ тәылақәак раҳцәа џьоукы-џьоукы реиԥш,  ачыни амали рзы сыжәлар сҭир.	- Я был бы изменником, если бы, как некоторые  князья на Кавказе, ради чинов и богатства  предал бы свой народ.
Аха, Аллаҳ иџьшьоуп, ишубо еиԥш, урҭқәа срызхымхит.	Но, слава Аллаху, как видишь, меня ничто не соблазнило.
 – Исоуҳәар ҟамлари, адунеи аҿы егьырҭ аҳәынҭқарцәа дуқәа ааизаны,  уҳәынҭқар, аублаақәа иҟарҵахьоузеи цәгьарас, аарас ирыдукылозеи, ҳәа иазҵаар, иреиҳәараны иҟои?	- Скажи мне, если бы собрались все великие государи и спросили бы твоего царя, что ему сделали плохого убыхи, в чем он их обвиняет, что он ответил бы им?
Ҵабыргуп	правда
зназыҳәа ҳхы шәымаадеит ҳара	мы когда-то приняли ваше подданство
ҳақәгәыӷуан ҳаԥсҭазаашьа еиӷьхап ҳәа.	надеялись, что жизнь наша станет лучше. 
амҩақәа	Дороги 
Аӷба	Корабль 
Шәара	Вы
ҳагаҿахь	К нашему берегу 
Азин рымшәхит ирҳәынҷаз атәцәа рыҭирагьы.	Вы запретили им продавать пленных, которых они взяли в бою.
Ҳамсылман дин ҳхышәхырц шәашьҭоуп. 	Вы хотите лишить нас нашей мусульманской веры.
 шәнапаҿы ҳшааҟалалак, ҳхәыҷқәа лкагәаны рнаҭра шәалагашт.	как только мы окажемся в вашей власти, вы начнете насильно крестить наших детей.
Абарҭқәа зегь рышьҭахь еинаалашьас иҳамоузеи?	После всего этого, как мы можем помириться? 
Аинрал ҿымҭӡакәа	Генерал молча 
ичабра ааҭиган	Вытащил платок 
 днаидгылан	Встал рядом с ним
усгьы ҿааиҭит	И сказал так 
Нас даақәҵәиаан	Потом повернулся
Бараҟаи-иԥа	Сын Баракая 
Бараҟаи-иԥа Аҳмеҭ, уххь згеит, исҭахуп сара, иахьа угәы иаанаго саҳарц.	Уважаемый Ахмет, сын Баракая,  мне хотелось бы услышать сегодня твое мнение. 
Бараҟаи-иԥа Аҳмеҭ	Ахмет, сын Баракая 
уаҳа	Больше 
Аилибакаара ҳагуп	Нам не хватает взаимопонимания
Аҳмеҭ Бараҟаи-иԥа, иуҭахуп, аҵәгьы мбылуа, акәацгьы ӡуа!	Ахмет, сын Баракая, ты хочешь, чтобы и мясо было поджарено, и палка, осталась цела!
Аинрал дааԥышәырччан	генерал улыбнулся
инапқәа	Его руки 
ашьшьыҳәа анеиааира дналагеит	медленно прошелся взад и вперед
Ҳаџьы Кьарантыхә иааигәара дааҭгылан	встав рядом с  Хаджи Керантухом
аӡбарҭагьы 	и суд
жәытәнатә аахыс	С древнейших времен 
дара ирзаанхоит 	Им останется 
уа ироуеит адгьыл	Там они получат землю 
Наӡаӡа	Навсегда 
аублаақәа ицааит 	Пусть убыхи 
 Ҟәбина	Кубань 
уи рҭахымзар, иқәҵааит Ҭырқәтәылаҟа". 	Если не хотят этого, пусть переселяются в Турцию».
 аинрал уаҳа акгьы ацымҵакәа днеин, иҭыԥ аҿы днатәеит. 	Генерал, ничего не добавив  сел на свое место. 
 игахт урҭ ажәақәа, дыдрак еиԥш!	Эти слова прозвучали как гром!
Мап, аинрал, уххь згеит, уи еиԥш ацәҟьа ҳхы ҳзаркуам.	Нет, господин генерал, мы не положим  голову капкан. 
ҳашьха	Наша гора 
нас	Потом
ишәҭахугьы	Что вы хотите 
иаразнак	Сразу 
Аха аинрал алаҿимҭит.	Но генерал не ответил. 
угәы иалымсын. 	Не обижайся. 
 аԥсуаа ирзеиӷьасшьо аублаа рзынгьы исҭахуп. 	Я желаю убыхам того же, что я желаю абхазцам. 
иуҳәо агәрахаҵара цәгьоуп	трудно верить тому, что ты говоришь 
Аублаа жәлар ирхашҭран иҟаӡам аҳәынҭқар еинралцәа урылагыланы изныкымкәа ушҳабашьхьоу.	Убыхский народ не забудет, как ты воевал против нас вместе с генералами царя.
аԥсуаа раҧхьагьы узлаҽхәаша рацәак иумаӡам. 	И перед абхазцами тебе тоже нечем похвалиться.
абри еиԥш арыцҳара ҳҭагыломызт.	мы не оказались бы в такой беде. 
аԥсуаагьы ҳаргьы	И абхазы, и мы 
иахьа	Сегодня 
уабду	Твой дед 
аҳ Қьалышьбеи	Князь Келешбей
АУБЛААҚӘА РЫХӘԤҲА ИШИԤЫЛАЗ	Как убыхи встретили своего молочного брата
 Самырзаҟаннтәи – Алгыд Емхаа, абжьыуаа рахьтәи – Гьыргәал Чачба, Бзыԥнтәи – ԥшьынҩажәижәаба шықәса ирҭагылаз Маан Кац. 	Емхаа Алгыда из Самурзакана, Гиргуала Чачбу из Абжуа и девяностолетнего Маана Каца из Бзыби. 
Ганкала, акыр игәаӷьыуацәан Маан Кац аублаа рахь идәықәлара, избанда уи, аҳ ихаҭа иеиԥш, аҳәынҭқар иеинралцәа дрывагыланы аублаақәеи, асаӡқәеи, далааи, ҵабалааи драбашьхьан	С одной стороны, казалось бы, брать с собой Маана Каца в эту поездку к убыхам было рискованно, потому что он, так же как сам владетельный князь, не раз заодно с царскими генералами воевал против убыхов, дальцев садзов
уажәы, уа иахьнеиуаз ицәырҵра аублаақәа иргәаланаршәар ҟалон уи ашьаус	сейчас его появление там могло напомнить убыхам об этом  кровавом деле
аха иара	Но он
уи амҩа дзықәломызт	Не мог отправиться в эту дорогу 
избанда	Потому что 
иаҳәшьа Ҳаџьы Кьарантыхә ԥҳәысс диман.	Его сестра была замужем за Хаджи Керантухом.
Маан Кац	Маан Кац
 хынтә 	Трижды 
амаҳә	Зять 
дрыцымцеит 	Не пошел с ними 
Далааи Ҵабалааи рахьынтәи	Из дальцев и цебельдинцев 
Маршьан Алмахсиҭ	Маршан Алмахсит 
аҳ	Князь 
аха уи	Но это 
Ашәарыцара	Охота 
дзыхнымҳәызшәа ҽыҵгас иҟаҵаны	Сделал причиной будто не смог вернуться 
уи алагьы	Этим 
аҳ даҽазнык иирдырит	Еще раз дал понять князю 
Гьач Рашьыҭ	Гечба Рашид
дышьҭырхран иҟан	Должны были взять его с собой 
аха убригь	Но и он 
сгәы бзиам	Мне не хорошо 
иҳәан	Сказал 
аҳ иахь	К князю 
рхымҩаԥгашьа	Их поведение 
аҽыҵга	Отговорка 
адырра	Знание 
уадаҩмызт	Было не сложно 
илахь еиқәнаҵеит	Расстроило его 
ахәыцра	Мысли 
хьанҭақәа	Тяжелые 
Ус аныҟамла	Если так не случится 
амҩа хьанҭа данықәлоз 	Когда он отправлялся в трудный путь 
игәы	Его сердце 
ицырҳәар	Если они скажут вместе с ним 
аублаақәа иаҳа ишизыӡырҩуаз идыруан	Он знал, что убыхи его больше послушают 
Аҳ Ҳамыҭбеи Чачба	 князь Хамутбей Чачба 
арҭ аҩыџьа	Эти двое 
иара изы иҿыцмызт	Это не было новым для него 
аха иахьа	Но сегодня 
агаҿа 	Берег 
Аԥсны аҳ	Князь Абхазии 
Мзымҭа аӡиас	Река Мзымта 
мраҭашәарахь рхы рханы	Двигаясь на запад 
ирықәтәаны	Сидя на 
флыкак.	фелюга. 
ԥсыӡкҩык	Рыбак 
Амшын	Море 
изакәызаалак	Что бы ни было 
шьҭыбжьык	Звук 
иҭатәан	Сидело внутри 
– Изтәхарыдашь ари афлыка?	– чья может быть  это фелюга?
Аҳ иҽы	Конь князя 
аӷәра	Узда 
даахеит	Потянул 
  инеихьӡаз имҩалацәа	Догнавшие его спутники 
усгьы днаразҵааит:	И спросил так:
ишькыл днангыланы	привстав на стременах
аурысқәа	Русские 
даацәажәеит Маан Кац	Заговорил Маан Кац
– Ҭырқәа ҭуџьарк итәхап	– Наверно, турецкого купца 
– даацәажәеит Гьыргәал Чачба	– сказал Гиргуал Чачба.
ԥсҭазаашьас ирымоузеи?	Как им жить? 
аублаақәа ак рымҭир, 	Если убыхи что-нибудь не продадут,
ак аарымхәар 	Если что-то не купят 
аиаша ҳҳәозар	По правде говоря
– Шәыԥшишь, шәыԥшишь	- Посмотрите, посмотрите 
ма	Или 
англыз контрабанда ныҟәцаҩык	Английский контрабандист 
анҭ жәбома?	Видите те? 
убама?	Ты увидел ?
англыз	Английский 
абнарахь	В лес 
ахалара иаҿын.	Поднимались. 
иццакы-ццакуа	В спешке 
Џьоукы	Кто-то 
абџьар	Оружие 
ҩажәижәаба ҽы	Тридцать лошадей 
иреиҵамкәа	Не меньше 
Урҭ абнара иаҵәахаанӡа	Пока лес не спрятал 
аҳ иҩызцәеи иареи	князь и его друзья
– Ари хәарҭам	– это плохо 
даара ихәарҭагәышьам.	Очень плохо. 
аха аублаақәа ршьа ахҭнырҵаран иҟоуп	но убыхи заплатят кровью
Сара исыздыруам	Я не знаю 
Арыцҳара шыҟало збагәышьоит!	Вижу , что будет беда!
даацәажәеит Ҳамыҭбеи	Заговорил Хамутбей
илахь еиқәыршьшьы	Расстроено 
иара убас ауп ашәҟәгьы ишанырҵаз.	И так записали в книгу. 
игәныркылт абарҭ ажәақәа. 	Запомнили эти слова. 
ашәышықәса алагамҭазы	Вначале столетия 
аҭаҳмадцәа	Старики 
Аԥснытәи аҳ Ҳамыҭбеи Чачба уи амҩа данықәлоз аԥхьагьы иоухьан аинрал-адиутант чын	Владетельный князь Абхазии Хамутбей Чачба еще до того как отправился в этот путь получил   звание генерал-адъютанта
имаҷымкәа арратә орденқәеи.	Немало армейских орденов 
иаҳҳәап 	Например 
ашьхарыуаа	Горцы 
Уажәы Аублаатәылаҟа амҩа данықәыз 	Сейчас по дороге в страну Убыхов 
Аублаатәылаҟа амҩа данықәыз?	Когда он отправлялся в страну убыхов? 
Иҟалазеи	Что случилось 
Уи аҭак аҟаҵара сҽаламгалакәа, аԥхьаҩ игәаласыршәар сылшоит, аҳ Ҳамыҭбеи Чачба ибиографиа ахьынтәи крызҵазкуа хҭысқәак.	Не пытаясь ответить на этот вопрос могу напомнить читателям о некоторых важных фактах биографии владетельного князя Хамутбея Чачбы
сеидру	Не знаю 
аха уеизгьы	Но все же 
уи дзызхәыцшаз иман.	Ему было о чем подумать. 
амҩа данықәыз аҽны	В тот день, когда он был в пути 
аицәажәара	Разговор 
урҭ идыруадаҩуан	Они усложняли 
аҳ иҭагылазаашьа	Положение царя 
аублаақәеи иареи	Убыхи и он 
 аҳәынҭқар иеинралцәа 	Генералы царя 
убри алагьы	Этим самым 
 имчра ирӷәӷәеит. 	Укрепил свою власть. 
Ҟрымтәи аибашьра ҟалаанӡагьы	Еще до начала Крымской войны
ишаҳҳәаз еиԥш	Как мы  сказала 
ашьхарыуаа	Горцы 
Ҟрымтәи аибашьраан, Аԥснытәи аҳ ауадаҩра бааԥс дҭагылеит.	во время Крымской войны абхазский князь оказался в трудном положении.
Мрагыларахь 	На восток 
ацара иаҿын	Шли 
ма Новороссиискҟа, ма Ԥуҭҟа рыхқәа дырхон...	Направлялись или в Новороссийск, или в Поти…
аӷбақәа	Корабли 
шьапыла	Пешком 
Аҳәынҭқар иеинралцәа, астратегиа ҳасаб азуны,	 генералы царя по стратегическим соображениям, 
аамҭала Аԥсны агаҿа иқәыргон архәҭақәа...	временно выводили из Абхазии свои военные силы…
Аԥсны аҳ изыҳәангьы уажәшьҭа ара аагылара шәарҭан.	И для князя Абхазии оставаться здесь уже было опасно. 
Дхынҳәит	Вернулся 
иаҳраҿы дыҟазарц иҭаххеит	Захотел быть в своей княжестве 
ихьлакгьы	Чтобы с ним ни случилось 
дзаанымгылт	Не смог остановиться 
аҭауадцәа Дадианаа рахь 	К князьям Дадиани
 ааскьара ишаҿыз ибеит асулҭан иӷбақәа	Увидел , что приближались корабли султана. 
Аҟәа ааигәара дааихьан	Уже приближался к Сухуму 
данԥшы	Когда посмотрел 
хараӡа	Далеко 
даннеи 	Когда он пришел 
сасцәак	Гости 
игәашә	Его ворота 
Аҳҭны	Княжество 
иԥсы ааиҭакха имҭакәа	Не успев отдохнуть 
Аԥсныҟа рҿаархеит	Направились в Абхазию
Урҭ зегь раԥхьа аҳ диҭааит	Раньше всех них князя посетил 
Кавказ ашьхарыуаа	Горцы Кавказа 
авизир ду	Великий визирь 
ари ашәҟәы	Эта книга 
Абираҟ	Флаг 
 Ҳамыҭбеи Чачба идимкылт.	Хамутбей Чачба не принял. 
Ҳамыҭбеи Чачба идимкылт 	Но Хамутбей Чачба не принял
Сара сқьырсиан иашоуп	Я христианин
даҽа сасык 	Другой гость 
Маҳмедбеи ихьӡуп	Его зовут Мехмедбей
 ар ркомандаҟаҵаҩы 	Командир армии 
еицырдыруаз авантиурист	известный авантюрист
Европатәи	Европейский 
Ҵабыргыҵәҟьан	На самом деле
 иҟазшьа	Его характер 
К. Маркс излазгәеиҭаз ала	Как заметил К. Маркс 
уи арԥыс	Этот парень 
Мраҭашәараҿы	На западе 
ироль	Его роль 
аниба	Когда увидел 
Мрагыларахь диасит 	Перешел на восток 
ироль ҿыц ихәмарырц.	Чтобы сыграть его новую роль. 
Егьырҭ асасцәа реиԥш абригь	Как другие гости и этот 
аусқәа	Дела 
дызусҭда уи аҿагылара зылшо	Кто сможет сопротивляться этому 
рымчқәа анеибырҭа	Когда соединили свои силы 
далагеит иара.	Начал он. 
ахьӡ-аԥша	Честь-слава 
афинанстә цхыраара	Финансовая помощь 
амал	Богатство 
Иреиӷьӡоу абџьар хыкқәа	Самые лучшие виды оружий 
ажәабжь бааԥсы	Плохая новость 
Аха урҭгьы амыхәеит	Но и они не помогли 
Лондонтәи агазеҭ «Таимс»	Лондонская газета "Таймс"
Аҟәантәи иҩуан	Писал из Сухума 
урҭ амшқәа раан 	В те дни 
акорреспондент	Корреспондент 
сԥыхьашәеит	Мне попалось 
Аԥснытәи аҳ	Абхазский князь 
усҟан	Тогда 
иҭагылазаашьа аилкаара	Понять его положение 
Урҭ ҳара ҳацхыраара аҭыԥан, ҳныҟәара зырманшәалашаз кыр цҳақәа ԥырххааит	Они вместо того, чтобы  помочь нам, разрушили несколько мостов, которые облегчали бы наше движение
иахьрылшо амҩақәа дырбгоит.	портят везде, где могут, дороги.
рыцхыраарала	С их помощью 
Убри ашьҭахь	После этого 
Аурысқәа хынҳәит Аԥсныҟа. 	Русские вернулись в Абхазию.
мраҭашәарахьтәи 	Западный 
Аха Кавказтәи аибашьра	Однако кавказская война
иалгон абар-абар.	Вот-вот заканчивалась. 
1862 шықәса рзы Аԥсны заҵәык ада	В 1862 году кроме Абхазии 
аҳ Ҳамыҭбеи Чачба дыхьчауа,	Защищая князя Хамутбея Чачба, 
Уи инырра Аԥсны адагьы егьырҭ агәыларатәи ажәларқәа рҿы, сара изла здыруала, макьана даара акраҵанакуа иҟоуп.	Влияние его в не только в Абхазии, но и  на соседние племена, как мне известно, еще очень важно.
Убри аҟнытә, уи ауаҩ ҳара даҳзыбзиан иҟаҵара, даараӡа ихәарҭаны исыԥхьаӡоит».	Поэтому расположить этого человека к нам считаю очень полезным»
аҳ ифункциақәа	Функции царя 
џьара	Где-то
ахьыӡҵәҟьагьы	Даже название 
Аԥснытәи аҳра	Абхазское княжество 
аҵыхәтәанынӡа	До конца 
иԥхьаӡон	Считал 
даҽакала дахәаԥшуан ари аус.	По-другому смотрел на это дело. 
Аха ҩышықәса рыҩнуҵҟала аамҭақәа рҽырԥсахт иахьеицәаз ахь. 	Но за два года, времена переменились к худшему. 
Кавказ анаместник ҿыц аҭауад ду Михаил Николаи-иԥа	новый наместник Кавказа, великий князь Михаил Николаевич
Аԥснытәи аҳ иҿынӡа иааҩуан абарҭ ажәабжь бааԥсқәа	До абхазского князя  доходили эти ужасные новости
иаҳагьы	Еще 
Урыстәылан	В России 
Аурысқәа рабџьармчреи 	Военные силы русских и 
Ҳаџьы Кьарантыхә гәымшәара игым	Мужества у Хаджи Керантуха хватало
хара анаԥшра ицәмаҷуп	Ему не хватает дальновидности 
аха изхәарҭагәышьоузеи	Но чем это поможет 
Еиҭасҳәахуеит	Повторяю
Ихаҵа	Поверь 
иуҭаххаргьы	Если захочешь 
ихоумҵан	Не верь 
дад Шәарах	дорогой Шарах
аӡә иакәым	Не один 
ҩынтә-хынтә исаҳаит 	Два-три раза я услышал 
ҩаха-ҩымш	Два-три дня 
аҽыхәа дирбарц	Чтобы показать им коня 
раԥхьаӡа	Впервые 
Убасҟан аҳ Ҳамыҭбеи Чачба	Тогда князь Хамутбей Чачба 
ҩаха-ҩымш	Две ночи и два дня 
ҿымҭӡакәа	Молча 
амҩа иқәыз	Тот, кто был в дороге 
Ҳамыҭбеи хәыҷы 	Маленький Хамутбей 
быжьшықәса	Семь лет 
акәадыр	Седло 
Ашкәакәа	Белый 
Уи дзааӡаз Адагәа-иԥа Ҳаџьы Бырзықь	Воспитавший его Хаджи Берзек, сын Адагвы
Рышьҭахьҟа	За ними 
шәҩык	Сто человек 
ар рашәа	Военная песня 
Иҟоузеи, иҟоузеи ҳәа ажәлар еизҵаауан	Что происходит, что происходит спрашивал народ друг у друга 
издыруазгьы аҭак нарырҭон	кто знал, отвечали им
Аԥснытәи аҳ Сафарбеи иԥа	сын князя  Абхазии Сафарбея
аублаақәа ааӡара ирымаз	который был отдан на воспитание убыхам 
иаб иахь ддыргьежьуеит	Его возвращают к его отцу
Хаха-хымш	Три дня и три ночи
Ҳамыҭбеи хәыҷы	маленький Хамутбей
Аублаатәыла инижьыз ианаӡӡеи дааигәалашәеит 	он вспомнил свою молочную мать, которую оставил в стране убыхов
акьыжыҳәа аҵәыуара дналагеит	горько заплакал
Лыхныашҭа	Лыхнашта
Ҳамыҭбеи хәыҷы	маленький Хамутбей
Иабаӡӡеи иҩызцәеи иареи	Его воспитатель и его друзья 
Абас далгеит Ҳамыҭбеи Чачба иажәабжь.	Так закончил свой рассказ Хамутбей Чачба.
аублаа жәлар рхаҭарнакцәа	Главы народа убыхов 
амра	Солнце 
Быҭха	Бытха 
ашҭа	Двор 
аԥынҵа	Нос 
– Иҟалазеи?	– Что случилось?
уаҩ дызбаӡом	Ни одного человека не вижу 
ари змаанахарызеи?	Что это может означать? 
– иҳәеит аҳ, днаԥшы-ааԥшуа.	– сказал князь, оглядываясь. 
Даҽа маҷк	Еще немного 
шәҩык иреиҵамкәа	Не меньше ста человек 
аҳәсақәа	Женщины 
рхы инаркны ршьап аҟынӡа	С головы до ног 
рыхцәы	Их волосы 
ааскьара иаҿын.	Приближались 
 иара уаҵәҟьа	Там же 
арҭ абацои	Куда они идут
Иҟалазеи?	Что случилось?
Иԥсыда?	Кто умер?
аҭакәажә	Старуха 
лыхцәы 	Ее волосы 
гәыԥҳәыхшла дзааӡаз ианаӡӡеи	вскормившая его своим грудным молоком молочная мать 
Адагәа-иԥа Ҳаџьы Бырзықь иԥшәма	жена Хаджи Берзека, сына Адагвы.
Аҳ Ҳамыҭбеи ианаӡӡеи дшаагәеиҭазҵәҟьа	князь Хамутбей как только заметил свою молочную мать 
иҳәан	Сказал 
санаӡӡеи аҳкәажә, иҟалазеи?	Моя молочная мать княжна, что случилось? 
Аҭакәажә, аԥсы дихатәазшәа	Старуха, словно сидела  у изголовья покойника
Лааӡамҭа 	Ее воспитанник 
лыбла	Ее глаза 
уабатәида	Откуда ты
сара усыздырӡом	Я тебя не знаю 
 иуаҳахьоума?	Слышал ли ты? 
Гәыԥҳәыхшла исааӡаз	вскормленный моей грудью
Ҳамыҭбеи дыԥсит	Хамутбей умер 
аха дышԥаԥси	Но как умер 
Аублаақәа дырцәыӡит рыхәԥҳа хазына. 	Убыхи потеряли своего молочного брата.
Аԥсуаагьы дырцәыӡит раҳ изықәгәыӷуаз!	И абхазцы потеряли своего князя, на которого надеялись ! 
ҭаҷкәымла лхы дасуа	ударяя кулаками в голову
иара ибзыцәаҳәшьа 	Его молочная сестра 
О, ишԥалури убзыцәаҳәшьа, Ҳамыҭбеи?	О, что ей делать, твоей молочной сестре, Хамутбей?
Узааӡаз аублаақәа	Воспитавшие тебя убыхи 
Уԥсит	Ты умер 
аха ушԥаԥси	Но как умер 
 иахьа.	Сегодня. 
Ҳаџьы Кьарантыхә	Хаджи Керантух
бзыцәашьак иеиԥш акәым, аӷа иеиԥш диԥылеит	его встретил не как молочного брата, а как врага.
– Бҵәыуала, санаӡӡеи	– Плачь, моя молочная мать
шәҵәыуала, сыбзыцәаҳәшьцәа!	Плачьте, мои молочные сестры!
Шәааӡамҭа, саргьы сшәыцҵәыуоит!	Я, ваш воспитанник, плачу вместе с вами!
Ушьҭан шәахьымӡар ҳәа сшәоит!	Потом боюсь, не успеете !
Уаҳа иҟам	Больше нет
АЛОУ -ИԤА ШЬАРДЫН	Шардын, сын Алоу
Ҳҭаацәа зегьы рзы имыждеиқәаҵәахаз уи амш аҽны	В тот день, который стал кошмарным для нашей семьи 
аибашьрахь иҟаз сашьа еиҵбы Мата ида	кроме моего младшего брата Маты, который был  на войне 
аҭаацәа зегьы аҩны ҳаиқәшәаны ҳаҟан	вся семья была дома
Уи аурысцәа дырҿагыланы рабашьра даҿын	Он воевал  с русскими
 иаҳмаҳацызт.	Мы не слышали. 
аҩны 	Дом
Ашьыжь	Утро
иԥсахит	Поменял 
ахьаа	Боль
Саб Ҳамырза хымш раԥхьа иарӷьа напы ахы ақәшәан	Три дня назад в правую руку моего отца Хамирзы попала пуля 
аҩны иааин	Пришли домой 
Сани саҳәшьцәа аҩыџьеи агәылара ҩнарҭак аҿы	Моя мать и обе мои сестры в соседнем доме 
аҳабла ҳәсақәа	женщины  поселка
иацоуп ҳаныхынҳә	Мы вернулись вчера 
уажәы	Сейчас 
аизарахьынтәи	С собрания 
Кьарантыхә сицны	Вместе с Керантухом 
Ӡнын	Была зима 
Амш шьыбжьышьҭахьрахь инеихьан	день уже клонился к вечеру
еимагыланы илеиуаз асы аахкәеит	снег, густо падавший, сейчас перестал идти
игәыжь лаҟә дақәтәаны санду лааӡамҭа	Сидя на своем низкорослом муле воспитанник моей бабушки
Алоу-иԥа Шьардын.	Шардын сын Алоу.
– Ухәра шԥаҟоу, сыбзыцәашьа?	– Как твоя рана, мой молочный брат?
– дҵааит асас, саб данааидгыла.	– спросил гость, когда он подошел к моему отцу. 
– Ибаргу егьсымам, ухаҵкы сцеит Шьардын! – иҳәеит сабгьы, хьаак змаӡамыз иеиԥш дыххаччо, игәыдҳәалаз	– Не стоит говорить о ней, – ответил отец, признаться гостю в том, что его мучает боль, и
дацәыԥхашьаны	стесняясь
инапы ишьҭахьҟа иҵәахуа.	пряча  руку за спиной.
ҳгәыӷырҭа	наша надежда
Уи лышьҭахь игылаз саҳәшьцәагьы, иԥхашьаԥхаҵо, сан идлырбаз ныҟарҵеит.	Мои сестры, которые стояли за ней,  смущаясь, сделали то, что наша мама показала. 
Ҳахәԥҳа ҳишьҭагыланы зегьы аҩны ҳааҩналт.	мы все вслед за нашим молочным братом зашли в дом. 
иршәшәаны аҭӡаҿы иныкнасҳаит.	отряхнув, повесил на стену.
Алоу-иԥа Шьардын рацәак даумызт	Шардын, сын Алоу, был не очень высокий
Ҳарҭ аиҵбацәа 	Мы, младшие
усгьы	Итак 
аха сани саби, ҳахәԥҳа иаҵкыс қәрала ишеиҳабацәазгьы	но моя мать и мой отец, хотя они оба были старше нашего молочного брата 
Сан, ишыҟалҵац еиԥш, 	Моя мать, как она обычно делала, 
абӷьааҳәа	сразу же
 - Ушырхәыз здыруан	– Я знал, что тебя ранили 
ҭаацәашәала	Семейно 
саргьы бзиа сшыжәбо здыруеит.	Я знаю, что и меня вы любите. 
Аамҭа бааԥсык ҳҭагылеит	Наступило тяжелое времена 
Абас ацәажәара даҿын Алоу-иԥа Шьардын	Так говорил Шардын, сын Алоу 
абжьааԥны еиԥш акәымкәа	Не так, как обычно 
иҳаиҳәарызеи?	Что он нам скажет ? 
ари ақыҭа зегьы	Вся эта деревня 
ҳашҭаҿы 	В нашем дворе 
Абри еиԥш амыҟәмабара аамҭазы 	в такое беспокойное время
аҭуџьарцәа Ҭырқәтәылантәи изааргалон	ему привозили из  Турции купцы.
 – Ишыжәдыруа еиԥш	- Как вы знаете 
аха макьана	Но пока 
Уаҵәы	Завтра
Уажәы хаҭала сара сгәаанагароуп ишәасҳәо	Сейчас я говорю вам свое мнение 
аҳәынҭқар иеинралцәа араҟа уаҳа нхашьа ҳарҭом, ижәбоит	генералы царя не дадут нам больше жить здесь, вы видите 
амца 	Огонь 
Аԥса ҳахаԥсыр аҵкыс	Прежде чем всех нас проткнут штыками,
еиӷьӡами ҳаԥсы еиқәҳархар?	не лучше ли спастись?
Аллаҳҭаала изаҵәу аҭырқә сулҭан ду ҳрыцҳаишьоит, ҳхы имаадар,	Турецкий султан, наместник Аллаха на земле, пожалеет нас, если мы примем его подданство, 
Жәаха Сҭампылнтәи иааз ҭырқәа ҭуџьарк дысҭан. 	Позавчера ночью у меня гостил турецкий купец, который прибыл из  Стамбула.
иареи сареи ҳаибадыруеижьҭеи акрааҵуеит	Он и я давно знакомы 
ҳагәра еибагоит	Доверяем друг другу 
амал ду импыҵаку адагьы	Он не только богат
ахәаахәҭра мацара азыҳәан акәымхаргьы ҟалап ҳара ҳашҟа дзыӡхыҵыз.	Наверное он приехал к нам не только за тем, чтобы,  торговать
мраҭашәарахьтәи ҳгәылацәа 	Западные соседи 
Асулҭан иажәа дамеижьеит	Султан сдержал слово
Џьанаҭ ада	Кроме Рая 
уи адгьыл	Эта земля 
акы иузадкыло иҟам	Ни с чем не сравнить 
ишоурам	Не жарко 
ихьҭам	Не холодно 
есымша ааԥынроуп	Всегда весна 
Аа, иаргьы ахьыҟоу! 	Вот и оно!
аха иаԥхьагәышьодаз	Но кто бы прочитал 
нбан здыруаз	Кто знал буквы 
ҳара аҭаацәа уаҳҟәаҵ	Нас, семью, оставь 
ҳқыҭа зегь 	Вся наша деревня 
аӡәгьы дуԥыхьашәомызт.	Никого не встретил бы 
Иара ҳахәԥҳа ихаҭагьы аарла-аарлаҳәа акәын дшаԥхьоз.	и наш молочный брат сам еле-еле читал
 уи ауаҩ	Этот человек 
абас ихы иҭҳәааны изыҩрызу?	Он смог бы такое сочинить ?
Ҳзижьарызеи ҳара иашьцәа?	Зачем ему нас обманывать , его братьев? 
аԥсҭазаара	Жизнь 
удыруазааит	Знай 
арахь	Сюда 
Абас инҵәоит сыуа бзиа Мураҭ исалам шәҟәы.	Вот так заканчивает письмо моего хорошего родственника Мурата. 
Унапаҵаҟа иҟоу ауаа уманы	если ты с подвластными тебе людьми 
Абар Мураҭ ииҩуа	Вот, что пишет Мурат
Иаҳзыԥшузеи	Что нас ждет 
ацхыраарагьы ҳарҭоит	И помощь окажут 
Ҟәбина	Кубань 
Амҵ реиԥш ҳанҵәараны ҳаҟоуп!	как мухи погибнем!
Ара абна ҳшагәылатәоугьы ахьҭа ҳакуеит	Мы и здесь, среди лесов, мерзнем 
ҳдингьы	И наша вера 
Насгьы ишәаҳахьазар акәхап	Также, вы , наверное, слышали 
Урыстәыла	Россия 
анхацәа зегьы адгьыл аахәара рықәшәеит.	Всем крестьянам пришлось покупать земли. 
уа ҳаннеи	Когда придем туда 
ҳаҷкәынцәагьы солдаҭра иргалашт	И мальчиков наших возьмут в солдаты
ҳара ҳанхаҩы илшома нас, адгьыл аахәара?	Сможет ли наш крестьянин купить землю? 
Нас дгьылда анхаҩы ԥсҭазашьас имоузеи?	Как будет жить крестьянин без земли? 
Уареи сареи, ӷрак ҳаицҭымшааит, аха гәыԥҳәык ауп ҳзааӡаз	мы рождены с тобой не из одной утробы, но вскормлены одной грудью
иашоуп	Правильно 
сыбзыцәашьа бзиахә Ҳамырза!	Мой молочный брат Хамирза!
иуасҳәаз уаҳаит	Ты услышал, что я сказал тебе 
уажәшьҭа уара сузыӡырҩырц сҭахуп!	Теперь я хочу тебя послушать! 
Саб, аҵла ҩа еиԥш дҩанҭхьӡа дгылан	мой отец стоял, как засохшее дерево
инапы ихәыз егьи изнапык аҵыргәаны икын.	придерживая другой рукой раненую руку. 
ҭынчран	Было тихо 
иажәа	Его слово 
аӡын агәҭан	посреди зимы 
Уи акәхап сабгьы лассаамҭа иҿы зизеихымхуаз.	Наверное поэтому мой отец долго не мог раскрыть рта 
ахшыҩ 	Ум
Сыхәԥҳа	Мой молочный брат 
сгәыӷырҭа ду	Моя большая надежда 
Нас, дмыццакыкәа, дналагеит	Потом не спеша начал 
умаҵ аура	Служить тебе
Уара уахьцалак сҭаацәеи сареи ҳуцуп	Куда бы ты ни поехал, я и моя семья  будем с тобой 
Уаҳа иуасҳәагәышьозеи, цәаӷәареи рашәареи рыда акгьы ззымдыруа сара анхаҩы шьҭаха.	Что еще могу сказать тебе я,  крестьянин, который кроме того, что  пахать и сеять больше ничего не знает? 
аублаақәа зегьы рзы 	Для всех убыхов
Амала, сыхәԥҳа, гәыбӷан сумҭан сахьуазҵаауа	Но, мой молочный брат, извини , что спрашиваю 
 маҷк 	Немного 
Аублаақәа зегь ртәы саламцәажәеит	Я не говорил за всех убыхов 
сара схатә гәаанагара ауп ишәасҳәаз	Я сказал вам свое мнение 
изасҳәазгьы сгәакьацәа шәоуп!	И кому я это сказал, вам, моим близким! 
аҭак ҟаиҵеит Алоу-иԥа Шьардын	Ответил Шардын, сын Алоу 
сыхәԥҳа, сгәыӷырҭа! – деиҭаналагеит саб Ҳамырза.	Мой молочный брат, моя надежда! - опять начал мой отец Хамирза.
сыхәԥҳа, сгәыӷырҭа! – деиҭаналагеит саб Ҳамырза.	Мой молочный брат, моя надежда! - опять начал мой отец Хамирза. 
зегь ирыхьуа еицҳахьыр еиӷьӡами?	не лучше ли чтобы с нами случилось то, что со всеми? 
– Ус акәзар	- раз так 
– Ҳажәлар 	- наш народ 
амца	Огонь 
амшын	Море 
зегь раԥхьа	Раньше всех 
ҳабџьар каԥсаны	Бросив наше оружие 
Ҳнапала излаҳарцәарызеи ҳабацәа рхәышҭаара?!	Как нам собственной рукой, потушить очаг наших предков?!
Изланҳажьрызеи ҳаҩны, ҳгәара, ҳаԥсцәа рҳаҭгәынқәа? 	Как нам оставить наш дом, наш двор,  могилы наших покойных?
 ҳцома?	Пойдем? 
Быҭха	Бытха
дгьыл ҽыҭқәак шҳамоугьы	Имея немного земли 
Ҳхатәыдгьыл ҳшықәгылоугьы	Находясь на своей земле 
ҳхы аарлаҳәа иныҟәаагоит.	С трудом обеспечиваем себя. 
адгьыл	Земля 
злааҳхәо	Чем купим 
иахҭнаҳҵо	Что потратим 
иҳамоузеи?	Что у нас есть? 
Ҭырқәтәылангьы ҳзықәшәо сеидру	Не знаю, с чем мы столкнемся и в Турции 
ҳаннеилак	Когда мы придем 
Ҟәбина	Кубань 
уара уиашоуп	Ты прав 
Иҳамоу зегь кажьны	Бросив все, что у нас есть 
издыруада	Кто знает
уаҟагьы адгьыл аахәара ҳақәшәар?	Вдруг и там нам придется покупать землю? 
 сара	Я
сан	Моя мама 
саб иажәа 	Слово моего отца 
анагӡаха имҭакәа	Не дав ему закончить 
Уа Ҵабал сашьцәа зҭагылоу здырхуада?	Кто знает, что там в Цебельде с моими братьями? 
Урҭ арахь иааныжьны, амшын сызлахыларызеи, нас, сара?	Как я могу, оставив их здесь, уплыть за море?
 дҵәыуон сан	Плакала моя мать 
рылаӷырӡ	Их слеза
саҳәшьцәагьы	И мои сестра 
рыхқәа	Их головы 
аҵәыуара иналагеит.	Начали плакать. 
сҭаца	Моя невестка 
уажәы иҟабҵо бара ибаҭәам!	Тебе не подобает то, что ты делаешь сейчас !
Ҵабалаа ианакәзаалакгьы ихацәан	цебельдинцы всегда были настоящими мужчинами 
Адырра зласымоу ала	Насколько мне известно
иҟалап уажәшьҭа	Возможно уже сейчас 
урҭгьы ҳара иаҳзыԥшуп	Они тоже нас ждут 
иалихыз...	То что он выбрал…
џьанаҭ дгьыл аҿы	На благословенной земле 
Башьцәеи бареи дук хара имгакәа, шәеибга-шәеизҩыда шәеибабараны шәыҟоуп	Твои братья и ты скоро увидитесь здоровые и невредимые 
Ҳамырза, уа хәыдаԥсада адгьылгьы ҳауеит	Хамирза, там мы получим землю бесплатно 
ҳзыԥшуп!	Нас ждёт!
аамҭагьы	И время 
урҭқәа сырзымхәыцхьоу џьумшьан	Не думай , что я не думал об этом 
иуҳәо саҳауеит	Я слышу, что ты говоришь 
сыбзыцәашьа	Мой молочный брат 
арахә реиԥш	Как скот 
Ҳдин	Наша вера 
ирнаҭыр?	Если их покрестят? 
Сибра	Сибирь 
иаанхазгьы арахә реиԥш	И оставшихся, как скотину 
ҳаҩнқәа	Наши дома 
еиҳа еиӷьума	Разве лучше 
Аха суазҵаауеит	Но я спрошу  тебя 
Иажәа алгаха имҭакәа	Не дав ему договорить 
ҳаҩны	Наш дом 
агаҿантәи	С берега 
иҳаҳаз.	То, что мы услышали. 
– Уара	– ты
унапы	Твоя рука 
ҳаҷкәын	Наш сын 
уздыруам	Не знаешь 
лыблақәа 	Ее глаза 
даҿын сан Наси	Говорила моя мать Наси 
дгәааны	Обиженно 
уи уажәы аҵәыуара даҟәыҵын	Сейчас перестала плакать 
– Ибуазеи, бара? 	– Что с тобой?
Ачҳара 	Терпение 
иахьа еиԥш ахаан бсымбац!	Такой как сегодня я тебя никогда не видел! 
– налҿаирхьит саб.	– укорил ее отец.
шәҭахымзар	 Если не хотите 
лассы	Быстро 
уаханатәгьы аҽырхиара шәалага	Начинайте собираться с этой ночи 
уахь, Ҭырқәтәылаҟа!	Туда, в Турцию! 
 зҭахыз	Тот, кто хотел 
Аха, ишыжәбо, 	Но, как видите, 
аамҭацәгьа	Тяжелое время 
ҳарԥарцәа	Наши парни 
аха уара уоуп	Но ты 
уахь	Туда 
ҳхы дархәаны	Использовав его 
шәыжәла	Ваша фамилия 
сҩахарц сҭахын...	Хотел поднять…
иудыруеит уи сара сымшала ишыҟалаз.	Ты знаешь, что это случилось из-за меня. 
Заурҟан	Зауркан
сара сахь даахьаԥшит Алоу- иԥа Шьардын	Шардын, сын Алоу, повернулся ко мне
Уажәшьҭа уиԥырҵыр цәгьам.	Теперь не плохо было бы, тебе отойти от него. 
Уигь	Он тоже 
имҳәамырза	тайком
иуацәа-иҭахцәа еидигалоит.	Собирает своих родственников. 
Ҭырқәтәылаҟа адәықәлара игәы иҭоуп	он собирается отправляться  в Турцию
гәакьа	Родной 
Аиаша уасҳәап	Скажу тебе правду 
сара сыбзыцәашьа	Мой молочный брат 
маҵуҩыс димазарц сҭахым!	Не хочу, чтоб он был рабом! 
снапы	Моя рука 
Алоу-иԥа иажәақәа	Слова сына Алоу 
сгәы иалаҟацаз.	уколовшие меня в сердце. 
аҟама аҵарра еиԥш 	словно острием кинжала
сзымчҳакәа	Не выдержав 
– Ҳаџьы Кьарантыхә иԥсы ҩыҭшәаанӡа деибашьуеит. 	 – Хаджи Керантух будет сражаться пока он не умрет.
ишәан ихьаҵқәо дреиуаӡам.	Он не из тех, кто отступает испугавшись. 
саацәажәеит сара	Заговорил я 
ҭоуба зухьеит	Я уже поклялся 
– Ишәыхьзеи?	– Что случилось с вами?
шәцәажәашьа сгәы иахәом!	Мне не нравится, как вы разговариваете!
аби-ԥеи	Отец и сын 
уара	Ты
Шәара шәакәӡамзи	Разве не вы 
ҳаԥхьа шәгыланы	Стоя перед нами 
аибашьрахь	На войну 
ҳазҳәоз	Тот, кто нам говорил 
иҭахаз	Тот, кто погиб 
џьанаҭ агәашә 	Врата Рая 
изаатуеит	Откроется ему 
Уажәы еибашьрада аџьанаҭ шәыԥшааит	Сейчас вы нашли рай без войны 
уи Ҭырқәтәыла акәзаап	Оказывается, это Турция 
уахь шәаала	Пойдемте туда 
ажәраанӡа шәабаҟаз, шәарҭ хаиҳабацәа?	Где вы были раньше, вы наши  старшие? 
Ашьарҩаш икаҭәаз ахә зшьода?	Кто оценит пролитую кровь ? 
Ҳхацәа 	Наши мужчины 
башаӡа иҭахаз	Напрасно погибшие 
рыгәнаҳа здызкылода?	Кто возьмет на себя их грех ?
Саб, уара уакәымзи ҳшыхәыҷқәаз акыкахш иадкыланы ахаҵара ҳалазҵоз	 мой отец, ты же с молоком матери  воспитывал с детства в нас мужество 
аԥсадгьыл зхы ақәызҵаз жәлары дырхашҭуам	Народ не забудет того, кто погиб за родину 
саҿын сара ацәажәара	Говорил я
даара исцәыуадаҩны.	Мне было очень трудно. 
схы	Моя голова 
Убри аҽны адагьы	Кроме того дня 
абас	Так 
сыбжьы	Мой голос 
ахаан	Никогда 
ҳахәԥҳа ду	Наш великий молочный брат 
уиҟәаҵ	Оставь его 
сабҵәҟьа	Даже мой отец 
– Уҽаанкыл, аҷкәын, иуцәажәашьоузеи!	– Успокойся, мальчик, как ты разговариваешь! 
аха	Но 
уаԥхьа итәоу дызгәоумҭозеи?	Почему ты не обращаешь внимание на сидящего перед тобой ? 
ҳгәыӷырҭа ду	Наша большая надежда 
Ҳара ҳаиҭахымзар, ари еиԥш ахьҭаха аранӡагьы дасуа даарымызт.	Если бы он не хотел нас, не приехал бы сюда в такой холод. 
акы ҳҳәазаргьы	Если мы что-то сказали 
уара уоуп изаҳҳәаз	Мы сказали тебе 
угәы иалумырсын.	Не обижайся. 
Дад Шьардын	Дорогой Шардын 
Уара уҳәатәы хаҳамҵар, уаҳа ҳаззыӡырҩрыда?	Если мы не прислушаемся к тебе, то кого нам слушать ? 
Ҭырқәтәылан бзиарак шаҳзыԥшу агәра гаҵәҟьаны уҟазар	Если ты действительно веришь, что в Турции нам будет хорошо 
ҳара ҳгәакьа уами	Ты же наш родной 
сҭаацәагьы саргьы уара иахьуҳәо ҳаҟоуп	Я и моя семья будем там, где ты скажешь 
даҿын саб	Говорил мой отец 
Алоу- иԥа Шьардын дахьтәаз иааигәарахь днаскьаны	Подвинулся поближе к нему, туда, где сидел Шардын, сын Алоу
игәы нхеит ҳәа дшәозар акәхарын.	Наверное боялся, что он обиделся. 
Асас иудырратәы иаҳа даалахҿыххеит	гость заметно оживился 
аҭаацәа дааҳалаԥшын, усгьы ҽааиҭит	Посмотрел на нас, на семью , и сказал так
иҟамчы	Его плеть 
имагә	Его сапог 
Уажәшьҭа зыԥшра ҟамҵакәа аҽырхиара шәалага.	Теперь не медля начинайте собираться. 
 улаба 	Твоя палка 
хынҩажәа	Шестьдесят 
Саргьы ацхыраара сҭахуп	Мне тоже нужна помощь 
Уара, Ҳамырза	Ты, Хамирза
излазбо	Как я вижу 
ухәра уиаҟара ибаргәым	рана твоя не такая опасная
урҭ қәрала зегьы уреиҳабымзаргьы	Даже если ты не старше их по возрасту 
уашьцәа	Твои братья 
ужәлантә	Твои однофамильцы 
уажәа иазыӡырҩуеит.	Прислушиваются к твоему слову. 
Иаҟәыҵааит аибашьра	Пусть перестанут воевать 
иаҟәыҵааит баша ашьакаҭәара.	Пусть перестанут проливать напрасно  кровь. 
шәҽазшәырхиа	Подготовьтесь 
акы шәацәымшәан!	Ничего не бойтесь! 
шәыхәԥҳа, Алоу-иԥа Шьардын шәаԥхьа днагылоит	Ваш молочный брат, Шардын, сын Алоу, встанет впереди вас 
зегьы исызраҳәа.	Передай всем. 
Ҟәбинаҟа ахыҵразы џьара цәажәарак ҟалозаргьы,	А если пойдёт разговор о переселении на Кубань, 
ироуҳәаша удырп!	Ты поймёшь, что им сказать!
адҵақәа наҳаҭаны	Дав нам задания 
ҳахәԥҳа игәыжь днақәтәаны дцеит.	Наш молочный брат сел на своего мула и уехал. 
ирыԥхьаӡон.	Считали. 
абӷа	Спина 
ҭынчуп	Спокойный 
Ус иҟан	Так было 
ҳаамсҭцәа	Наши дворяне
ианныҟәоз	Когда ходили 
рқыҭа аҩнуҵҟа мацара 	Только внутри их деревни 
агәыжь иақәтәон	Садились на мула 
Аҭаацәа	Семья 
Сан, абжьааԥны еиԥш,	Моя мать, как обычно, 
акәытқәа ҭалымкит	Не закрыла кур 
 арахә	Скот 
иаанхеит	Осталось 
ажәқәа имхьеит	Не подоил коров 
Инапы	Его рука 
ахәышҭаара дыҽҳәатәоуп	Сидит у очага 
 иаҳагьы ирацәахазшәа збоит	Мне кажется, что их стало еще больше 
аԥхӡы	Пот 
иӡамҩа	Его щека 
Агаҿантәи	С берега 
ҳахьтәоу	Там, где мы сидим 
абзарбзан	Пушка 
ҳла 	Наша собака 
 Аҵыхәа	Хвост 
ажәқәа	Коровы 
шәцома?	Уходите ?
саҳауеит	Слышу 
Акәытҵара	Курятник 
аҵла	Дерево 
арбаӷьқәа	Петухи
ажәабжь бааԥс	Плохая новость 
Ахәылбыҽха	Вечер 
 саргьы	Я тоже 
снапқәа	Мои руки 
ҳабацәа ирықәлоу	Ровесник наших отцов 
ахәышҭаара	Очаг 
Урҭ иаҳагьы игәакьахеит, иԥшӡахеит, иҳалалхеит...	Он стали еще роднее, красивее, добрее…
нхаҩык диԥҳан	Была дочерью одного крестьянина 
Лассы-лассы маӡала ҳаиқәшәон	Мы часто тайком встречались 
Сҭаацәа	Моя семья 
ачара аҽазыҟаҵара иалагахьан.	Они уже начали готовиться к свадьбе. 
хәыҷы-хәыҷла	По чуть-чуть 
уаҵәы	Завтра 
дыԥшааны слацәажәарц.	Найти ее и поговорить с ней. 
дахьыҟазаалакгьы	Где бы она ни была  
Исыӡбеит	Я решил 
Сашьа Мата 	Мой брат Мата 
саҳәшьцәагьы.	И мои сестры. 
ҳла шит	Наша собака залаяла 
џьоук 	 кто-то 
ааигәа	Рядом 
Ашә 	Дверь 
санындәылҵ	Когда я вышел 
ҩыџьа арԥарцәа	Двое парней 
Аҩны данааҩнаргала, иоуразоуроу аҟәада ихьшын. 	Когда его занесли домой, он был весь окровавлен.  
Сани саҳәшьеи иааикәшеит	Моя мать и сестра окружили его 
 – Шәымшәан	- Не бойтесь 
иуаҭәашшара хәуп	Его бедро ранено 
иҩызцәа руаӡәы	Один из его друзей 
акгьы имыхьит	С ним ничего не случилось 
ацхыраара ишәҭ	Окажите ему помощь 
ҳарҭ ҳашьҭахьҟа ҳахнымҳәыр ҟалом!	Мы не можем не вернуться назад!
– иҳәан	- сказал 
аҩыџьагьы	Оба 
ишәырлас!	Поспешите!
аӡыршы ҳҭаххоит 	Нам понадобится горячая вода 
Сара даасыԥхьан	Позвал меня 
имаҭәақәа ҳаԥсахит	Поменяли его вещи 
сара сицхраауан	Я помогал ему 
Зны ахырҵәы ӡҩаны идыржәит, нас ацхарпа ҟаҵаны иҿаҳҵеит.	сначала разбавленное водой мацони ему дали выпить, а потом приготовив кашу с медом  накормили его. 
Убасҟан ауп, саб, иҟәардә днахан	Тогда мой отец, подвинув свой стул 
ачымазаҩ иаԥхьа данаатәа.	Когда сел рядом с больным. 
умшәан! – иҳәеит иара	не бойся! - сказал он 
Анцәа урыцҳаишьеит	Бог пожалел тебя 
– Ишәарҭоу акгьы ыҟам! 	- ничего опасного нет!
Уеибганы аҩныҟа ухынҳәит!	Ты вернулся домой невредимым! 
-  Сыхнымҳәыр акәымзи ибзиаз, саб!	– Лучше было бы не вернулся, отец мой! 
бзиарак ыҟам	Нет ничего хорошего 
ҳаӷацәа 	Наши враги 
Иаанхаз	Оставшиеся 
жәиԥшьҩык аҽцәа	Четырнадцать всадников 
Сара, ишыжәбо еиԥш	Я, как видите 
суаҭәа ахы ақәшәеит	Пуля попала в мое бедро 
зегь еицырдыруаз	Которую все знали 
аха уеизгьы 	Но все равно 
асы снылаҳаит	Я упал в снег
иаразнак	Сразу 
Сҩызцәа уажәшьҭа иабаҟоу?	Где сейчас  мои друзья ?
сҩызцәа ахьҭахоз сҭахар акәын саргьы!	Я должен был погибнуть там же, где и мои друзья! 
Ахьымӡӷ усыргеит	Я опозорил тебя 
сан лқашь ыфауа.	Кушая кашу моей мамы. 
О, саб агәымшәа	О, мой бесстрашный отец
ари хьымӡӷуп	Это позор 
изысҭахузеи уажәшьҭатәи аԥсҭазаара?!	Зачем мне теперь такая жизнь?!
– Уҭынчха, сыҷкәын, дад, - аҳәара даҿын саб	– Успокойся, мой сын, дорогой, – говорил отец
Аибашьраҿы усоуп ишыҟоу,	На войне так происходит, 
џьоук ҭахоит, џьоук аанхоит аамҭала, 	Кто-то погибает, кто остается временно, 
уашьҭантәи аидыслара аҟынӡа!	До следующей битвы! 
Ачымазаҩ илацәа нҭааит	Больной уснул 
Саб иаха еиԥш акәымкәа, иаҳа длахҿыхын уажәы	Мой отец, не как сегодняшней ночью, был более бодрым сейчас 
мчылаҵәҟьа акрааҳҿеиҵеит.	Насильно накормил нас. 
Ачымазаҩгьы маҷк деиӷьшәа дааԥшит.	И больной проснулся будто ему немного лучше. 
Саб  дааин, ус даацәажәеит:	Мой отец пришел, и сказал так:
– Уарбанзаалакгьы, дыԥҳәыс-дхаҵа, гәкажьра шәмыхьроуп!	– Кто бы ты ни был, мужчина или женщина, вы не должны падать духом!
Ахаан ҳазқәымгәыӷуаз ҳзыҟалеит	С нами случилось то, на что мы никогда не надеялись 
Диашоуп ҳахәԥҳа	Прав наш молочный брат 
еибашьрак ахьыҟам дгьылк ҳзыԥшаауазар, ҳдәықәлап.	Если мы сможем найти землю, где нет войны, отправимся.  
Уаҳа шәымԥшын, шәалага аҽырхиара!	Больше не ждите, начните собираться!
– Ишԥа?	– Как? 
саб, закәызеи иуҳәо?	Отец мой, что ты говоришь? 
ихәрагьы  	И его рана 
ииарҭа	Его кровать 
сашьа	Мой брат 
– Уҽырҭынч	– Успокойся
Ҭырқәтәыла џьанаҭ дгьылуп рҳәоит	Говорят, Турция райская земля 
амлеи ахьҭеи 	Голод и холод 
Ҳдәықәлап 	Отправимся 
ҳахәԥҳа	Наш молочный брат 
абас даҿын саб	Так продолжал говорить мой отец 
иаха	Сегодня ночью 
– ҿааиҭит Мата	– закричал Мата
ҩаԥхьа ииарҭа даақәтәаны.	Снова сев на свою кровать. 
– Уара уакәымзи аибашьра ҳадызцалоз? 	- Ты же отправлял нас на войну? 
иахьа?	Сегодня? 
Иугәаларшәа заҟаџьара уеибашьхьаз	Вспомни, в скольких битвах ты был.
иԥхьаӡа 	Посчитай 
– Иҟоуҵозеи, Мата?	– Что ты делаешь, Мата?
ашоура умоуп	У тебя жар 
Исгәалашәоит, исхашҭрангьы сыҟам урҭқәа зегьы	Помню и не забуду все это 
– Мап, мап, жәлары зегьы ус ихәыцӡом!	– Нет, нет, весь народ так не думает! 
 ҳԥыза 	 наш предводитель 
иԥсы ҭанаҵгьы	И пока он жив 
идгьыл гәакьа нижьырцгьы дыҟам!	Не оставит родную землю!
Алоу-иԥа Шьардын иеиԥш	Как Шардын, сын Алоу 
Саб, акы уамжьааит	Отец мой, не дай себя обмануть
Абас акыраамҭа	Так долго 
ҳҩыџьагьы	Мы вдвоем 
сара саалгар Мата дналагон	Если я заканчивал , начинал Мата 
Иара дтәаны даҳзыӡырҩуан	Он сидел и слушал нас
иҳамеикуамызт	Не спорил с нами 
аха уеизгьы	Но все же 
ҳаргьы дҳақәшаҳаҭхомызт.	Но и не соглашался с нами. 
Нас дҩагылан, илабашьа аакыдихын	Потом встал, взял свой посох.
ашә 	Дверь 
– Жәлары зегьы ирҳәо ҳаҳап	- Послушаем, что скажет весь народ 
ҳамацара	Сами
даацәажеит иара.	Заговорил он. 
Нас, сара даасыхәаԥшын, абасгьы нациҵеит	Потом посмотрел на меня и добавил так 
Заурҟан	Зауркан
уара	Ты
уца	Пойди 
Ҳаџьы Кьарантыхә аизарахь дноугозар акәхап	Наверное ты поведешь Хаджи Керантуха на собрание 
ҳаиҳабыра	Наше правительство 
уалаӡырҩы	Послушай 
иахьеи уаҵәи	Сегодня и завтра 
акы рмыӡбар ԥсыхәа ыҟам усгьы.	Не имеют возможности что-то не решить. 
Сара ақыҭа сналалап,	Я обойду деревню,
снарацәажәар сҭахуп ҳажәлантәқәа.	Хочу поговорить с однофамильцами. 
Урҭ ирцәызӡарым 	Я не скрою от них 
ирасҳәап Алоу-иԥа Шьардын ирзынижьыз ажәа	Скажу им, что просил передать Шардын, сын Алоу 
Ирҳәо саҳап, нас!..	Услышу, что они потом скажут!..
Акаамеҭ ҟалоит	Будет кошмар 
анырҳәа	Когда сказали 
уҽумшьын! 	Не убивай себя!
– Уеилагама?	– Ты с ума сошел?
наҟ уҽырҭынч сымҳәеи!	Я же сказал успокойся!
– Мата днаиқәцәҟьеит саб.	– крикнул мой отец на Мату. 
– Мап, уи диашоуп	– нет, он прав
џьаргьы умцароуп, саб! 	Ты не должен никуда идти, отец!
Сани, саҳәшьцәеи, сареи 	Моя мать, мои сестра и я
АҴЫХӘТӘАНТӘИ АИЗАРА	Последнее собрание 
зынӡак жәохәҩык ракәӡан иалахәыз.	Всего пятнадцать человек участвовали. 
Урҭ рахьтә	Из них 
жәеиза 	Одиннадцать 
Урҭ рахьтә, иаҳҳәап: ҳара ҳахәԥҳа Алоу-иԥа Шьардын	Из них, например: наш молочный брат Шардын, сын Алоу
Аллаҳҭаала иаҳзалихыз алахьынҵа мчыла аҿагылара гәнаҳауп 	сопротивляться судьбе, предначертанной нам Аллахом грех
ҳамҩа ҿыц!	Наша новая дорога! 
Иахьшоурам	Там, где не жарко 
иахьыхьҭам	Там, где не холодно 
Уи адгьыл Ҭырқәтәыла	Эта  земля Турция 
шәааи амсылманцәа	Идите мусульмане 
capа сахь	Ко мне 
игылан	Стоя 
иаҳзыԥшызар	Если ждёт нас 
 сшәазҵаауеит, иарбан ҳара ҳнызкыло	Я спрашиваю, что нас останавливает?
ҳаззыԥшу?	Чего мы  ждем?
уи иахьанӡагьы	Он и до сегодняшнего дня 
асҵәҟьа ихтны акәымзаргьы	Даже если не так открыто 
Ҵоуп, иҟан, егьмаҷҩымызт уи иадымгылозгьы.	Правда, были, и не мало тех, кто ее поддерживал это. 
ҳара  ҳхатәы дгьыл ҳамоуп, нас, ҳзаҳәарызеи џьоук рыдгьыл!	У нас есть своя земля, зачем нам просить  чужую!
Мап, ҳара ҳаҩны ҳаҟоуп.	Нет, мы у себя дома. 
Ҟәбинагьы ҳҭахым, иара убас Ҭырқәтәылагьы!	Не хоти Кубань и также Турцию!
Мап, мап, дырҩегьых мап	Нет, нет и еще раз нет
ублаа заҵәык иҟны ҳнеиаанӡа ҳаибашьуеит!..	Мы будем сражаться до последнего убыха!..
ашәыргәындақәа иахьырҭаху ицааит	Пусть трусы уходят куда хотят
ихылԥа аашьҭыхны	Подняв свою шапку 
асаба нақәыршәшәаны	отряхнул пыль
ус инаиваҵаны днатәеит Ноурыз.	 положив рядом с собой сел Ноурыз. 
– Диашоуп Ноурыз, диашоуп!	– Прав,Ноурыз прав!
– иаагеит абыжьқәа.	- раздались голоса.
– Тәыс ҳаҟамызт, ҳагьыҟалом!	– Мы не были и не будем рабами!
ҳаԥсадгьыл ҳшьапы ықәгылоуп!	Мы стоим на своей родине!
Ҵабалаа	Цебельдинцы 
Далаа	Дальцы 
Асаӡқәа	Садзы 
нас иарбан ҳара ҳзыцәшәо	Так чего же мы боимся 
дарбанзаалак аӡә иаԥхьа рхы ладмырҟәыцызт,	Ни перед кем не склоняли они свои головы, 
Аԥсны зегьы!	Вся Абхазия! 
– Ҳаибашьуеит	– мы будем воевать 
дарбан сгәалашәом	Не помню кто 
– Шәаагыл. 	– Подождите.
Ҳаџьы Кьарантыхәгьы дизыӡырҩуан	И  Хаджи Керантух слушал его 
ҳаҭыр иқәиҵон.	Уважал его. 
Сиҭ ибжьы шаараҳаз, зегьы ацәажәарақәа иаарҟәаҵын, инеизыԥшит	У слышав голос Сита, все прекратили разговоры, обернулись к нему
аха иара дгылан уаҳа акгьы мҳәаӡо.	Но он стоял больше ничего не говорил. 
– Сиҭ, уара ахшыҩ ду змоу уаҩуп – ҿааиҭит Ҳаџьы Кьарантыхә.	– Ты мудрый человек, Сит, – сказал Хаджи Керантух.
иҳауҳәозеи?	Что же ты нам скажешь? 
–сара сыхшыҩ хәыҷ иазышьҭыхуам ари еиԥш аус ду.	– Мой маленький ум не для такого большого дела. 
Ишәасҳәозеи	Что же я вам скажу 
рыԥсы ҭагәышьазар	Если они живы 
Ишәҭаху шәҳәала	Говорите, что хотите 
сара стәы усгьы иӡбоуп	Мое итак решено 
Убасҟан дҩагылеит Бараҟаи-иԥа Аҳмеҭ	Тогда поднялся Ахмет, сын Баракая
Ноурыз иашьа еиҵбы.	Младший брат Ноурыза. 
аха ԥсыхәа ахьынӡамаз иҵәахуан	Но насколько возможно скрывал 
Бараҟаи-иԥа Аҳ меҭ аурысқәа рахь дицәыиасыр ҳәа дшәон.	Он боялся, что Ахмет, сын Баракая может перейти к русским.
иаразнак ацәажәара даламгеит	 заговорил не сразу
ихьтәы сааҭ ааҭиган	Вытащил свои золотые часы 
иааирҽеит	Поправил 
наҟ инаиҵәахит	Обратно спрятал 
иарӷьа напы	Его правая рука 
Изхарада?	Кто  виноват?
Раԥхьа иргыланы – ҳара.	В первую очередь – мы.
Шәааи, иаахтны ҳаицәажәап	Давайте поговорим открыто 
Шәгәы иалымсын	Не обижайтесь 
– Уанбаҿыхеи, Бараҟаи-иԥа!	– Когда ты проснулся, сын Баракая!
Уара уакәымзи, мшәан, Ҳаџьы Бырзықь  ҳаԥхьа дангылаз аахысгьы ҳажәлар аибашьра иадызцалоз.	Не ты ли сам, еще в те дни, когда Хаджи Берзек предводительствовал нашим войском, громче всех призывал народ к войне. 
Дарбан, нас, уара уакәымзар Ҭырқәтәылеи Англызтәылеи ирызцоз ацхырааразы?	Кто тогда, если не ты ли ездил в Турцию и в Англию за помощью?
 иахьа уима?	Ты сегодня родился? 
уабаҟаз?	Где ты был? 
– Иуҳәо иашоуп, Ҳаџьы Кьарантыхә, абарҭ зегь шәеиԥш саргьы исымоуп агха.	– Ты прав, Хаджи Керантух, я  ошибался так же, как все вы. 
Усҟан сыԥсадгьыл ахақәиҭра сыхьчоз џьысшьон	Тогда я думал, что защищаю свободу своей родины 
Гәыбӷанс ираҳҭозеи аурыс еинралцәа?	В чем винить нам русских генералов? 
нас, асулҭан ҳиқәгәыӷны	потом, надеясь на султана
изааӡарызеи	Зачем скрывать 
Уанӡа сноумган	Не доводи меня до этого 
наҟ уҳалҵ	Уходи
Иҟалазеи, уара, сажәа анагӡаха сышәҭа!	Что случилось, дайте мне возможность договорить!
– Иуҳәаша уҳәахьеит, уажәшьҭа уаҳа иацуҵарызеи?	– Ты уже все сказал, что ты еще можешь добавить?
Аханатә еинаалеит аурысқәеи дареи.	Изначально они померились с русскими. 
ахьыԥшымра рцәыӡзаргьы, ауааԥсыра еиқәдырхеит	Даже если они потеряли независимость, они сохранили народ 
Аллаҳҭаала дшаҳаҭуп, удин еилоугоит ҳәа сыҟамызт!	Великий Аллах свидетель не знал, что ты способен изменить своей вере!
Ҳаздукылада ҳара?	 С кем ты нас сравниваешь?
Ақырҭқәеи аурысқәеи қьырсианцәан, ҳара ҳамсылманцәоуп, агьааурқәа ҳраӷоуп!	Грузины и русские христиане, мы, мусульмане, враги гяуров!
Иахьарнахыс уара Бараҟаи уиԥам, сара усашьам!	Отныне, ты не сын Баракая, ты не мой брат!
Аԥсахҩы	Изменник
– Уаҳа иуҳәарц иуҭахузеи?	– Что еще ты хочешь сказать?
Дара рзы ҳара ҳазусҭцәада?	Кто мы для них?
Исгәалашәоит, Лондон ҳаныҟаз	Помню, когда мы были в Лондоне
Даӷьсҭан иҟалаз шәаҳахьеит усгьы. 	Что произошло в Дагестане вы итак слышали. 
Шамильҵәҟьагьы дрымшьит	Даже Шамиля не убили 
Урыстәыла дынхоит	Живет в России
Иеибашьуаз даӷьсҭанаа ракәзар, аӡәгьы инимырҵәеит, инхоит, инҵуеит рыҩнқәа рҿы.	Дагестанцы, которые воевали, не истреблены, а продолжают жить в своих домах.
абар ҳгәылацәа шаԥсыӷаа шәрыхәаԥш	Посмотрите на наших соседей шапсугов
Ҩ-мҩак роуп иҳамоу ҳара	У нас только две дороги 
Уа бзиарак ҳзыԥшу џьышәымшьааит!	Не думайте, что там нас ждёт что-то хорошее! 
Зыԥсадгьыл нзыжьыз, бзиарак иԥеиԥшым	Покинувшего свою землю не ждёт ничего хорошего
 уажәшьҭа, ишәҭаху сзыжәу!	теперь делайте со мной что хотите! 
шьҭыбжьқәак аагеит	Раздались звуки 
ишьҭахь игылаз	Стоявший позади него 
– Иаҳзааугазеи саб иашьа?	– Что ты нам принёс брат моего отца? 
аарлаҳәа даацәажәеит	С трудом заговорил 
–  иаразнак ҳидимкылт аинрал Геиман	– Генерал Гейман сразу  не принял нас
ҳаԥшын	Мы ждали 
абаандцәа реиԥш асолдаҭ ҳарҷаԥшьон	Нас охранял солдат как заключенных 
Уажәшьҭа еинаалашьа ҳамам	Теперь мы не помиримся 
амҩа шәаҳҭоит.	Дадим вам дорогу. 
уа ишәзыԥшуп аӷбақәа!..	Там вас ждут корабли!..
Араҟа ожәшьҭа аанхашьа шәымам!	здесь теперь вы не можете жить! 
ибылуеит.	Горит. 
ари ажәабжь бааԥс	Эта плохая новость 
сзеилымкаазаргьы	Даже если я не понял 
ииҳәарызеишь	Что же он скажет 
иҟаиҵарызеишь	Что же он сделает 
 ҵаҟантәи	Снизу 
аҵлақәа	Деревья 
Убасшәа акәын, уажәы	Примерно так выглядели сейчас 
Ус адәныҟатәи иааҩхит ҽышьҭыбжьқәак	Вдруг снаружи снова послышался топот коня
агаҿа зҷаԥшьоз руаӡәы	Один из тех, кто охранял берег 
– Ҳаџьы Кьарантыхә, аҭырқә ӷбақәа ркаԥдан ажәа узааицҳаит! 	– Хаджи Керантух, главный капитан турецких кораблей передает тебе!
Хымш раахыс хәыдаԥсада, амшын ҳахгылоуп.	Уже третьи сутки мы стоим у берега бесплатно. 
англыз контрабанда ӷбақәагьы	корабли английских контрабандистов 
– Удәылцқьа наҟ!	– Убирайся!
– днаиҵаҟьеит аиҳабыра рхада.	– свирепо крикнул ему глава правительства. 
Агаҿа ҷаԥшьаҩ 	Дежурный берега 
ашә	Дверь 
агага еиԥш	Как тень 
Дзыхҟьаз уи акәзаарын	Вот чем он провинился 
Амҳаџьырра	Махаджирство 
аизара ҟалаанӡагьы 	Еще до собрания 
уи алагьы ихитит аублаақәа рԥыза имаӡа	Этим и раскрыл секрет предводителя убыхов 
аизараҿы	На собрании 
Ҳаџьы Кьарантыхә днаскьаԥхьан иеиҳәашаз	То, что он должен был сказать Хаджи Керантуху наедине 
ашьҭахь ауп сара ианыздыр	Я узнал только потом.
егьырҭ шәдәылҵ.	Другие выйдите. 
Уара Бараҟаи-иԥа Аҳмеҭгьы уаҳа ус умам араҟа!	 тебе, Ахмет, сын Баракая, тоже больше нечего делать здесь!
адәахьы ҳандәылҵит.	Вышли на улицу. 
Ҳашьҭахьҟа дҳашьҭалан дааиуан Бараҟаи-иԥа Аҳмеҭгьы.	Сзади шел за нами и Ахмет, сын Баракая.
Амш	День
аԥша	Ветер 
аԥсҭҳәақәа	Тучи 
амра аакылԥхеит	Солнце выглянуло 
Быҭха	Бытха 
аизарахь	На собрание 
амҩахәасҭақәа	Тропинки 
 сабгьы	И мой отец 
 Ирыӡбазеи аиҳабыра?	Что решило правительство? 
Ҳцауоу, ҳаанхауоу?	Уходим или остаемся? 
