Мшыбзиа, ҳаҭыр зқәу ахәаԥшцәа!	Добрый день, уважаемые зрители!
Иахьа ҳара ҳаигәырӷьоит	Сегодня мы рады приветствовать
астудиа «Аԥсны Хабар» аҿы ҳахьиԥыло еицырдыруа ашәҟәыҩҩы Анатоли Ким.	в студии «Апсны Хабар» известного писателя Анатолия Кима.
Сгәы иаанагоит, Анатоли Ким аиҳабыратә биԥарахь иаҵанакуа рыбжьара дызусҭоу аҳ́ара аҭахым.	Думаю, старшему поколению Анатолия Кима не нужно представлять.
Ари еицырдыруа аурыс шәҟәыҩҩуп, иуҳәар ҟалоит, асовет шәҟәыҩҩуп,	Это известный русский, можно сказать, советский писатель,
аха аҿар уи иӡбахә раҳәара аҭахуп,	но молодому поколению необходимо его представить,
избанзар Анатоли Ким ирҿиара аҿар имаҷны ирдыруеит.	потому что о творчестве Анатолия Кима мало кто знает из молодых.
Сгәы иаанагоит, ҳаицәажәара ашьҭахь аӡәырҩы ирҿиара ашҟа аинтерес рызцәырҵуеит,	Думаю, после нашего разговора многие заинтересуются его творчеством,
Анатоли Ким иҩымҭақәа ԥшааны, аԥхьара иалагоит.	найдут произведения Анатолия Кима и будут читать.
Сара Анатоли Ким шәҟәыҩҩык иаҳасабала дыздыруеижьҭеи кырҵуеит,	Я открыл для себя Анатолия Кима очень давно,
уи Аԥсныҟа дшааз ансаҳа,	и когда я услышал о его приезде в Абхазию,
иҿцәажәаразы агәазыҳәара соуит.	мне стало интересно с ним побеседовать.
Ҳаицәажәара аинтерес аҵан.	Наш разговор был содержательным и интересным.
Уи иахьа ари астудиаҿы иацаҳҵап ҳәа сыҟоуп. .	Думаю, мы его продолжим здесь, в студии.
Сара ароман-лакә «Белка» сеиҭаԥхьеит.	Я перечитал роман-сказку «Белка».
Уи ҿыц аартра сара сзы аинтерес аҵан.	Мне было интересно заново открыть его для себя.
Арҿиамҭа «Белка» аҟны акырӡа интересу ахаҿсахьақәа маҷымкәа иагәылоуп.	В произведении «Белка» много интересных образов.
Ароман аҟны иҟоуп аԥсуа мотивқәагьы.	В романе есть и мотивы наши абхазские.
Ҭыԥқәак рҿы Шәара Пицунда шәалацәажәоит, Гагра аӡбахә шәҳәоит,	В нескольких местах Вы говорите о Пицунде, говорите о Гагре,
усҟан Қырҭтәыла аҳәынҭқарра иатәыз аԥсуа ԥшаҳәа аҳасабала.	как об абхазском тогда побережье Грузии.
Уи аамҭазы Аԥсны Қырҭтәыла иахәҭакны иҟан, автономтә республиканы.	Тогда Абхазия была частью Грузии, автономной республикой.
Пицунда Шәара иаашәырԥшит иҵегьы ахаҿсахьақәа,	В Пицунде была вами названа и еще несколько образов,
ҿырԥштәыс иаагозар пицундатәи аеш.	например, образ пицундской белки.
Уаҟа сара сзы ихадоу ахаҿсахьа – амшынҳәа ауп.	Главный там образ все же у меня – дельфин.
Уигьы Амшын Еиқәа аԥшаҳәаҿы ицәырҵуеит,	Он тоже появляется на Черноморском побережье,
Шәара, иаҳҳәап, аӡбахә ахьышәҳәо:	у берегов Пицунды, где вы, например, пишите:
«.еиҳа унаскьаргеит хара, абар уахьынӡаргаз, аԥсуа ԥшаҳәа ашҟа, адунеи ҳәаақәызҵо аҿыҵга иабзоураны,	«.вернее, умчали тебя вдаль, вон аж куда, к абхазскому побережью, и все по причине твоего опасного непонимания истинных соотношений сил,
ахәҭакахьала, ҳашәҟәҭыжьратә дунеи-хәыҷ абзоурала».	правящих миром и, в частности, нашим маленьким издательским мирком».
Абар, еиҭа амшынҳәа аӡбахә:	Здесь еще есть о дельфине:
«Амшынҳәа уи аамҭазы Амшын Еиқәа ацәқәырԥақәа рыла аҵыхәшәыгәԥсыӡқәа ирышьҭан.»	«А дельфин в это время гнался по волнам Черного моря за косяком ставриды».
Аҵыхәшәыгә – еицырдыруа ԥсыӡуп (Аԥсны).	Ставрида – одна из популярных рыб (в Абхазии).
Раԥхьатәи сызҵаара,	Первый вопрос мой,
иарбан нырроу Пицундеи Аԥсни ишәырҭаз,	какое влияние все-таки Пицунда и Абхазия оказали на написание вашего романа «Белка»,
адунеи аҿы шәеицырдыруа шәҟазҵаз шәроман «Белка» аҩраҿы?	который сделал вас на весь мир знаменитым?
Сара иаахҵәаны ишәасҳәоит, амшынҳәа ахаҿсахьа ҟалаҵомызт,	Я сразу скажу вам, что не было бы образа дельфина,
35 шықәса раԥхьа ашәҟәыҩҩцәа Пицунда рырҿиаратә Ҩны ашҟа смаазҭгьы.	если бы не мой приезд в Пицунду 35 лет назад в Дом творчества писателей.
Уи дельфин, ароман иаԥхьараны иҟоу иртәызааит.	И этот дельфин для тех, кто, возможно, будет читать роман.
аха уажәы схаҭа зҵаарак шәысҭар сҭахуп. Ароман шәанеиҭаԥхьоз,	но прежде я хочу задать вам вопрос. Когда вы перечитывали роман,
игәашәҭа, ари ашәҟәы зегьы, ари ароман зегьы,	вы заметили, что вся эта книга, весь этот роман, по содержанию, по форме
ҵакылагьы, формалагьы аҿар ишрызку, иҿоу агәы ахьӡала ишцәажәо?	обращен к молодежи, и говорит от имени молодого сердца,
Акыр шықәса ҵуеит,	молодой души? Много лет назад уже,
35 шықәса раԥхьа иҭыҵит «Белка»,	35 лет назад у меня вышла «Белка»,
аха 10 шықәса раԥхьа	но лет 10 назад
сара Ҟазахсҭанҟа ааԥхьара сыман, Гумилиов иуниверситет ахь.	я был приглашен в Казахстан, университет Гумилёва.
Убра сара исзеиҿыркааит афилологиатәи, алитератураҭҵааратәи афакультетқәеи сареи ҳаиқәшәара,	И там мне устроили встречу с филологическим и литературоведческим факультетам,
акафедра анапхгаҩы сара сыԥхьаҩ лакәын,	завкафедрой этим отделением была моя почитательница,
уи лкандидаттә усумҭа лыхьчон «Белка» ала.	она защищала свою кандидатскую работу по «Белке».
Илдыруаз уи акәын, «Белка» апропаганда азылуан,	Это был ее конек, она пропагандировала «Белку»,
дагьы ирҵон. Сара снеимҭазы	и они изучали ее. И к моему приезду
«Белка» ақәлацәеи сареи ҳаиԥылара еиҿылкааит.	она устроила мне встречу с ровесниками «Белки».
Уи аамҭазы «Белка» 20 шықәса ахыҵит.	К тому времени «Белке» исполнилось 20 лет,
Убри аҟнытә, лара 20 шықәса зхыҵуа лыстудентцәа «Белка» иалмырԥхьар лымуит.	и она своих 20-летних студентов заставила прочитать «Белку».
Абас иҟан аинтерес зҵаз уи аиԥылара.	Вот такая была интересная встреча.
Ари ароман иҿоу агәы аҟнытә иҿоу агәқәа рахь хьаԥшроуп.	Это роман от молодого сердца обращенный к молодому сердцу.
Темалагьы, фантазиалагьы, метафоралагьы,	И тема, и фантазия, и полет фантазии, и многие метафоры
иҿоу ахшыҩ, иҿыцу ахшыҩеидкылара иазҳәоуп,	были рассчитаны именно на молодой ум, на свежесть восприятия,
иԥсхьоу алитературатә аарԥшышьақәа ирыцәхьаҵны.	без закостеневших представлений о ценности литературной.
Сара хаҭала ауаҩы иԥсоуп сызхьысырц исҭахыз. Шәара сшәазҵаар сҭахын,	Я непосредственно в душу обращался. Хотел у вас спросить.
ҳәарада, уи азҵаара аҭак аҟаҵара шышәцәыуадаҩхо сдыруеит аха.	Хотя, конечно, на этот вопрос вам трудно будет ответить.
Шәгәы иаанамгаӡои «Белка» аҿар рзы иажәхьеит ҳәа,	Не осталось ли у вас впечатления, что «Белка» устарела для молодежи,
иҿоу агәы аҟнытә иҿоу агәқәа рахь ахьаԥшра иаражәхьеит ҳәа ацәанырра шәмоуӡеи?	и для обращения от молодого сердца к молодому сердцу?
Сгәы иаанагоит, ииашахаҭоу арҿиара ажәра ақәӡам, еснагь иактуалтәуп.	Думаю, истинное творчество всегда актуально, никогда не устареет.
Уи теориоуп. Шәара шәԥышәа аҟнытә ишԥаҟоу?	Это в теории. А из вашего личного опыта?
Апрактикаҿ, ижәдыруеит иаԥышәҵаз ахаҿсахьақәа –	В практике, вы знаете, образы, которые вы создали, –
асахьаркыратә училишьче аҟны аҵара зҵо х-ҩык аҿарацәеи,	это образы трех молодых людей, которые учились в художественном училище,
аԥшьбатәи ахаҿсахьа, иара – аеш ахаҭеи,	и четвертый образ – это образ самой белки,
иахьагьы актуалра рымоуп.	они и сегодня актуальны.
Иахьагьы урҭ аԥсҭазаараҿы иаҳԥылоит, иахьагьы урҭ лабҿаба иаабоит.	И сегодня мы их встречаем в жизни, и сегодня мы их видим.
Иаҳҳәап, Митиа Акутин ихаҿсахьа. Уи убасҟак аинтерес аҵоуп,	Например, образ Мити Акутина. Настолько интересен этот образ,
убриаҟара инаунагӡатәуп, ицқьара ҷыдоуп,	настолько вечен, его чистота настолько непосредственна,
ашәышықәсақәа рҿы ари ахаҿсахьа аанхоит.	что в веках остается этот образ.
Ашәышықәсақәа рҿы иаанхо арҿиара – ааԥсаӡом.	Творчество, которое остается в веках не устаревает.
Сгәы шәырҭынчит, сагьшәыргәырӷьеит.	Вы меня утешили и порадовали.
Даҽа зҵаарак сымоуп шәара шәышҟа,	Ещё один вопрос к вам,
анашанатә реализм ҳахьалацәажәо азы,	поскольку мы говорим о магическом реализме
мамзаргьы алитератураҿы имистикатәу ареализм,	или же мистическом реализме в литературе,
ииашоуп, сара сабиԥара Маркес иԥхьаҩцәан, уи ахырхарҭа бзиа ибаны иҳаман.	правда, мое поколение зачитывалось Маркесом, и мы влюбились в это направление.
Абри ахырхарҭа, шәгәы ишԥаанаго,	Вот это направление, как вам кажется,
иахьа иҿиома? Уи шԥажәбо шәара иахьа?	сегодня развивается? Каким вы его видите?
Аинтерес зҵоу ажәабжьк шәасҳәарц сҭахуп, Леуан.	Я вам сообщу, Леван, интересную новость.
Ауаатәыҩса рдунеи аҿы алитература анцәырҵ инаркны амагиатә реализм ыҟа.	Магический реализм был с момента появления литературы в человеческом мире.
Гомер зегьы – магиатә реализмуп. Иҟазма ас еиԥш иҟаз ауаа, афырхацәа,	Гомер весь – это магический реализм. Разве были такие люди, герои,
Зевс, Аполлон, Афина, Посеидони уи иԥҳәыс Афродитеи?	как Зевс, Аполлон, Афина, Посейдон и его жена Афродита?
Гомер ироманқәа «Илиада», «Одиссеи»	В романах Гомера «Илиада» и «Одиссея»
рҿы арҭ афырхацәа злыхәу ахҭысқәа –	они присутствуют, и действия, которые происходят там,
амагиатә реализм акәӡами? Раԥхьатәи амшқәа инадыркны,	– разве не магические реализм? Вся литература с первых дней
иахьа уажәраанӡа алитература зегьы – магиатә реализмуп.	до сегодняшнего – это магический реализм.
Толстои Бородинтәи аидыслара атәы шааирԥшуагьы уахь иналаҵаны.	Даже то, как Толстой описывает Бородинскую битву.
Уаҟа Наполеон ихаҿсахьа даара илашарккароуп.	Образ Наполеона там очень ярок.
Иааҳгап егьырҭ афырхацәа. Николаи Растови, иқәыԥшу Пиер Безухови.	Возьмём других героев. Николая Ростова, еще молодого Пьера Безухова.
Уи, ани афранцыз дибоит, афранцыз иаргьы дибоит анапышьашәалатә еидыслараҿы,	Он видит этого француза, француз его видит в рукопашном бою,
афранцыз деилаганы, харантәи абџьар игәыдҵаны, дыҩны дцоит,	француз в ужасе бросает в него ружье издали и убегает,
Николаи шьҭахьҟа деихоит. Толстои дызлацәажәо арҭ адетальқәа зегьы	а Николай в обратную сторону. И все эти детали,
аҭыԥ рыман иара ихаҭа диаанӡа акыр шабжьаз.	которые описал Толстой, происходили задолго до его рождения.
Толстои диит 1828 шықәсазы,	Толстой родился в 1828 году,
аидыслара акәзар, уи 1812 шықәсазы иҟан.	а битва произошла в 1812 году.
Толстои убасҟак инарҵауланы ари аидыслара ааирԥшит, ихаҭа далахәызшәа.	И он описал ее так, будто он был участником этих событий.
Ари амагиатә реализм акәӡами?	Это разве не магический реализм?
Иҟамыз, зыԥсы ҭоу ак акәны иааԥшуеит.	То, чего не было предстает, как живое.
Уи оуп амагиатә реализм захьӡугьы.	Это и есть магический реализм.
Даҽакала иуҳәозар, алитература зегьы – магиатә реализмуп.	То есть вся литература – это магический реализм.
Ари аформула рхәыцын,	Придумали эту формулу и меня приписали к ней
сара исыдырҳәалеит баша. Сара сакәӡам ихацзыркыз ари ахырхарҭа,	совершенно напрасно. Я не открыватель,
сара сакәӡам ашьаҭа зкыз. Амагиатә реализм еснагь иҟан,	не основоположник этого направления. Магический реализм был всегда,
убри аҟынтә, сара сыхнахит, аҭҵааҩцәа	поэтому я польщен, что исследователи сказали,
ари ахырхаҭа садырҳәало саналага.	что я к чему-то принадлежу.
Аха ари хықәкылатәи аҭагылазаашьаҿы, сара исыбзоурам ареализм ашьаҭа акра.	Но в данном конкретном случае, увы, я не основоположник этого направления.
Иҭабуп аҭак азы. Ижәытәӡоу акультурақәеи, ижәытәӡоу ацивилизациақәеи рыӡбахә ҳҳәозар,	Спасибо за ответ! Если мы говорим о древних культурах, о древних цивилизациях,
Бырзентәылатәи ацивилизациа еиԥш иҟоу, ауаатәыҩса азы акыр ҟазҵаз.	таких, как Греческая цивилизация, которая сделала многое для человечества.
Абырзенцәа иҟарҵаз аҟнытә иахьауажәраанӡа ҳаԥсҭазаараҿы ҳхы иаҳархәо рацәоуп.	Многое из того, что основано греками мы сегодня используем в своей жизни.
Уи адемократиа, алитература, аҭоурых уҳәа, убас егьырҭгьы.	Это демократия, литература, история и так далее.
Аха ҳара иаҳдыруеит абырзен цивилизациа аҟынӡагьы ишыҟаз еиҳа ижәытәӡоу ацивилизациақәа. Уи Мысра ацивилизациа,	Но до Греческой цивилизации мы знаем, что были
ижәытәӡатәу ацивилизациагьы. Уи Мысра ацивилизациа,	и более древние цивилизации. Это цивилизации Египта,
Адгьылбжьахара, Индиа, иара убасгьы иҟан Китаитәи ацивилизациа. Урҭ рыӡбахә анысҳәа,	Междуречья, Индии, была также Китайская цивилизация. И говоря об этом,
ҳаицәажәара даҽа аспект ашҟа сиасыр сҭахын,	я хотел бы перейти к другому аспекту нашей беседы,
Кавказ ажәытәӡатәи ацивилизациак аҳасабала ишыҟаз, насгьы,	так как Кавказ является древнейшей цивилизацией, и
Кавказ, адунеи ажәытәӡатәи ацивилизациақәа ишрыдҳәалаз.	Кавказ общался с мировыми древнейшими цивилизациями.
Арарат инаркны, Апрометеи иҟынӡа, ажәытә епос ашьақәгылараҿы	И в формировании эпоса древнего, начиная от Арарата, заканчивая Прометеем,
Кавказ иадҳәалоу рацәоуп.	многое связано с Кавказом.
Сара еилыскааит, шәара ишгәашәҭаз афилософиатә хәыцра,	Я узнал о том, что вы ознакомились с таким направлением
иуҳәар ауазар, афилософиатә дунеихәаԥшышьа –	в философской мысли, можно так сказать, мировоззренческой –
Мураҭ Иаӷан иҩымҭа, акымкәа ашәҟәқәа рҿы	это произведение Мурата Ягана, где он в нескольких книгах
адунеи азы ифилософиатә згәаҭа,	описывает свое философское видение мира,
Ҷаамысҭа Қьабза» ала ацивилизациа азгәаҭара.	видение цивилизаций через «Аамста Кябза».
«Аамысҭа Қьабза», схазы ишазгәасҭаз ала,	«Аамста Кябза», я так для себя определил,
ари ижәытәӡоу ҳкультура амагиатә хырхарҭа иахәҭакуп,	это часть магического направления нашей древнейшей культуры,
ҳжәытә дыррақәа хыҵхырҭас измоу. Убри ҳалацәажәар сҭахын.	где есть истоки наших древних знаний. Об этом я хотел бы поговорить.
Даара ибзиоуп абри азҵаара ахьықәшәыргылаз.	Очень хорошо, что вы задали именно этот вопрос,
Избанзар Аԥсни аԥсуа жунеии рдырраҿы	потому что главным моим впечатлением
иреиҳау гәазнеираны исоуит	от знакомства с Абхазией и с абхазским миром
Мураҭ Иаӷан иԥылара. Сара сзы уи ҳамҭоуп.	является встреча с Муратом Яганом. Для меня это дар.
Зеӷьыҟам ари адгьыл аҿы инхо сҩызцәа аԥсуаа рҟнытә	Я не знаю, чем я это заслужил от моих абхазских друзей,
уи сызлаԥсахаз исыздыруам.	которые живут на этой замечательной земле.
Сара сзы уи ихадоу ҳамҭоу, акыр иаԥсоу, хәы змаӡам.	И для меня это самый главный дар, самый дорогой и бесценный.
Избан? Избанзар сара аҩнынтә философуп,	Почему? Потому, что я домашний философ,
уаанӡатәи абиԥарақәа рфилософиатә усумҭақәа	который занимается философией
ҭызҵаахьоу среиуам.	не потому, что изучил много философских трудов предшествующих поколений.
Хаидегер ихы ишазиҳәоз еиԥш,	Как говорил о себе Xайдеггер,
сара – сфилософуп, избанзар философра зуеит.	я – философ, потому что я философствую.
Саргьы схы уи аҩыза алшара асҭеит философра аура, сшыфилосафымгьы.	Я тоже себе дал такую вольность философствовать, не будучи философом.
Адипломқәа ҳәа акгьы сымаӡам,	Никаких у меня нет дипломов,
аршаҳаҭгақәагьы, ҳаҭыр зқәу ари аразриад сшаҵанакуа ала.	свидетельств о том, что я отношусь к этому почтенному разряду.
Шәареи сареи ҳаамҭа иаҵанакуа ауаҩы иаҳасабала,	Как человек нашего с вами времени,
аҩнытә философ иаҳасабала,	будучи домашним философом,
сара, ҳәарада, даара игәнызго ыҟоуп,	я, конечно, сильно переживаю о некоторых вещах,
хаҭала исыхҭысуа, мамзаргьы аурыс,	которые происходят не просто со мной, или же с русскими,
аԥсуа, америка жәларқәагьы зҭагылоу акәым.	или с абхазами, с американцами.
Адунеи зегьы исгәаԥхо акы ахҭысуеит.	Со всем миром происходит что-то такое, что лично меня далеко не устраивает.
Сареи сеиԥш ҳаамҭазтәи адунеи ауааԥсыра гәыԥҩык ирыдрымкыло акы.	Так же, как и многих людей нашего современного мира.
Уи ихадоу, шьаҭанкыла ак ацәыӡроуп,	Это утрата чего-то основополагающего и главного,
амазаратә ган акәӡам, иреалтәу ари аԥсҭазаараҿы алшара дуқәа узҭо	не в имущественном отношении, не в накоплении каких-то научных энергий, знаний,
анаукатә енергиақәеи, адыррақәеи ракәӡам сызҿу.	позволяющих иметь какие-то большие возможности в этой реальной жизни.
Ҳара иҳарӡит аԥеиԥш ду иадҳәалаз,	Мы утратили что-то главное, что обещает великое будущее,
ауаатәыҩса рабиԥарақәа зегьы Ахьтәы шәышықәса ҳәа изызгәышьуаз,	которое люди, живущие во все поколения, лелеют как мечту о Золотом веке,
Анцәа иаҳра иадҳәалаз ихадоу акы. Иҳарӡыз ахьтәы шәышықәсеи,	о царстве Божьем. Миф об утраченном Золотом веке
уи архынҳәреи рмиф. Ари агәазыҳәарахь ауаа ирыхоз амч хада ырӡуп,	и возвращении его. Главная сила, которая подвигает людей к этой мечте утрачена,
даҽакала иуҳәозар,	и все свелось к совершенному чистогану,
ауаатәыҩса рымчхара аԥсыҽхара иаҿуп,	и происходит ослабление колоссальных сил человечества,
анаука аенергетика ду шеидыркылазгьы,	несмотря на то, что люди набрали громадную энергетику науки,
гәарҭак адыррақәа шеизыргазгьы, аԥсабара азакәанқәа ишрылалазгьы,	собрали много познаний, вторглись в закономерности природы,
афизикатә мчреи алшареи шдырҳазгьы.	и обрели физическую мощь и способность.
Уи инаваргыланы ицәырҵит ҳдунеи аҵыхәтәа иадҳәалоу иреалтәу аҭагылазаашьа,	Вместе с этим настала абсолютно реальная ситуация о конце нашего мира,
аглобалтә ԥхарреи,	из-за глобального потепления, из-за того, что может быть
адунеи ықәызхыр зылшо аиадертә бџьареидкылеи,	уничтожение мира в результате колоссального накопления ядерного оружия,
иҟалап, аиадертә бџьар аиҳагьы ишәарҭоу акәзар,	и, может быть, более страшного, чем ядерное оружие,
амассатә нырҵәаразы ахимиатә, апсихологиатә бџьар.	химического, психологического оружия массового уничтожения.
Анаукеи адыррақәеи ирыбзоураны, ирацәаны ипозитивтәу алагамҭеи, аенергеи реингалара ала,	Вместе с накоплением огромных позитивных начал и энергий
ҳара акыргьы ҳуашәшәырахеит,	через науку и познание, мы обрели колоссальную уязвимость
ҳагьшәарҭахеит ҳдунеи иреалтәу аҵыхәтәа аҿаԥхьа.	и опасность перед реальным концом нашего мира.
Избан, ҳзазааигәахазеи уи ҳара?	Почему мы к этому подошли?
Сымацара сакәӡам, ихәыцуа ауаа зегьы уи амзызқәа еилыркаауеит.	Не только я, а все мыслящие люди видят причины этого.
Мзысс иҟоу убри ауп, ҳара адоуҳатә енергиа ҳцәыӡит, адоуҳатә лагамҭа ыӡит.	Причины этого, что у нас пропала духовная энергия, пропало духовное начало.
Уи адоуҳатә лагамҭа	И это духовное начало
сара избеит Мураҭ Иаӷан ишәҟәы «Аамсҭа Қьабза» аҟны.	я увидел в книге Мурата Ягана «Аамста Кябза».
Ари ашәҟәы ҳамҭас исиҭеит сжәытә ҩыза Руслан Џьапуа,	Эту книгу подарил мне мой давний друг Руслан Джопуа,
сасра санизаа. Ари ашәҟәы аԥхьара салагеит,	когда я к нему приехал в гости. Я начал читать эту книгу,
иаалырҟьангьы еилыскааит ари ашәҟәы аҿы схазы аҭак шызбо,	и вдруг понял, что в этой книге я нахожу для себя ответ,
иҟаҵатәузеи, ҳаамҭазтәи апокалипсистә ҭагылазаашьа аԥсахра азҵаараҿы?	что же нужно, чтобы преодолеть апокалиптическую ситуацию нашего времени?
Уи сара сзы зегь иреиҳау ҳамҭоуп.	Это, ведь, был самый большой дар для меня.
Издызбалеи уи зегьы сара?	В чем я увидел это все?
Ашәҟәы алагамҭа зынӡа имариоуп.	Начинается книга очень даже просто.
Уи иҳәоит аханатә Канада ауааи иареи аицәажәарақәа шрымаз,	Он говорит, что у него в начале были беседы с людьми в Канаде о том,
иԥсҭазаара ҭәны, ихарҭәааны аҟаҵаразы	как человеку использовать все данные ему возможности для того,
ауаҩы имоу алшарақәа зегьы ихы ишаирхәаша,	чтобы жизнь его была абсолютно полной и наполненной,
ихарҭәаау, ибарақьаҭроу аԥсҭазааразы	чтобы не упустить всех ему данных возможностей
имоу алшарақәа ицәымӡырц иҟаиҵаша иазкны.	для полноценной и изобильной жизни.
Анаҩс уи аҳәара далагеит	Потом он стал говорить о том, что
Кавказ ишыҟаз ижәытәӡоу адоуҳатә акультура,	существовала древняя духовная культура на Кавказе,
20 нызқь шықәса еиҳаны изхыҵуа, ус шакәу зыршаҳаҭуагьы ыҟоуп,	которая уходит корнями за 20 тысяч лет, свидетельства есть такие,
насгьы уи акультура Кавказ иит хыхь ҳаицәажәара алагамҭазы	и эта культура родилась на Кавказе задолго до тех цивилизаций,
зыӡбахә шәымаз ацивилизациақәа цәырҵаанӡагьы.	о которых вы говорили в начале нашей беседы.
Уи Мысратәи, Месопатамиатәи, Индиатәи, Китаитәи уҳәа.	Это и Египетская, и Месопотамская, и Индийская, и Китайская.
Анаукатә дырра дуӡӡақәеи, атехнологиатә лшарақәеи шҳамоугьы,	Обладая колоссальными научными знаниями
ҳара ҳанхоит Мураҭ Иаӷан ишәҟәаҿы	и возможностями технологическими, мы живем без этой энергии,
зыӡбахә имоу аенергиа ҳамаӡамкәа.	о которой говорит Мурат Яган в своей книге.
Аханатә инаркны ахдырра хыҵхырҭас иамоу аенергиа, мамзаргьы ахьышьҭра,	У энергии, источника, откуда изначально исходит сознание, а вместе с сознанием накопленные знания,
ахдырра инадҳәаланы еизгоу адыррақәагьы ирхылҿиаауеит арҿиаразы	и исходит самая главная воля к тому, чтобы
агәаҳәара хада узҭо, улшарақәа зегьы рааԥшра улзыршо.	созидать во имя полного осуществления своих возможностей.
Абар, ахыҵхырҭа иазку арҭ адыррақабар,	Вот эти сведения об источнике,
Кавказ Ельбруси Казбеки рыбжьара ицәырҵыз,	которые возникли на Кавказе, между Эльбрусом и Казбеком,
ԥсҭазаарала еимырдон ара, Кавказ,	передавались живым образом именно здесь, на Кавказе,
биԥарацыԥхьаӡа, акраамҭа.	из поколения в поколение, в течение этого огромного времени.
Мураҭ Иаӷан иҳәоит, саргьы уи сиқәшаҳаҭуп,	Мурат Яган говорит, я абсолютно с ним согласен, что истоком
адунеи адоуҳатә рҵарақәа зегьы рхьышьҭра, сара сызлацәажәо Мураҭ Иаӷан иҳаҵаиҳәо роуп,	всех духовных учений на земле, я говорю о сведениях, о которых говорит Мурат Яган,
аддоуҳатә хьышьҭра азхәыцшьа аарԥшын,	это на Кавказе были открыты понятия истока духовного,
адоуҳатә енергиагьы, ауаҩы	духовной энергии для созидания человеком
иԥсҭазаашьа иҷыдоу аформа амчала	с помощью его особой формы существования,
илшарақәа зегьы раартуа, ралыршаразы аҭагылазаашьа изҭо.	которое позволяет человеку полностью реализовать свои возможности.
Сара агәрасгаӡомызт,	Я бы не мог этого понять,
хаҭала уи аҩыза алахьынҵа смоузҭгьы. Акраамҭа уаҩы исызиаҳәомызт,	если бы сам не прошел такую судьбу. Я долго никому не мог признаться,
слитературатә рҿиараҿы	что в своем творчестве литературном,
сызхьыԥшуа акыршықәса исҵоз,	я исходил не из того, что слишком много чего-то изучил,
сзыԥхьоз, сыҩныҵҟа еизызгаз ракәӡамызт,	что-то прочитал, все это накопил в себе,
уи оуп аҩра сылзыршозгьы. Сара еидыскыломызт крызҵазкуаз аматериалқәа.	и это позволило мне писать. Я не собирал материалы какие-то очень важные.
Аханатә аахыс сара сыҩуан, Мураҭ Иаӷан ихы ишазиҳәаз еиԥш:	Знаете, с самого начала я писал так, как Мурат Яган сказал о себе:
«Аӡәы аказы дансазҵаауа, акгьы сыздыруам, аха аҭак ҟасҵоит	«Когда меня спрашивает о чем-то, я не знаю ничего, но я отвечаю
ииашаны ишысҳәо ала ахдырра сыманы».	с полным осознанием того, что я говорю правильно».
Саргьы изыҩуан имариамыз саԥҵамҭақәа «Белка», иара убас егьырҭ иҩымҭақәагьы,	Я тоже писал свои сложнейшие вещи, «Белку» и другие произведения,
смагиатә реализм зегьы, ишырҳәало еиԥш,	и весь свой магический реализм, как говорится,
ахаангьы аханатә исыздыруамызт изыҩраны сыҟан.	и никогда заранее не знал, что я буду писать.
Аплан ахаангьы иҟасҵомызт, аматериалқәа еидыскыломызт,	Я не строил никогда планов, не собирал материалы,
аҩымҭа аконцепциа еиқәсыршәомызт, ус баша снатәаны	не составлял концепции произведения, просто садился
аҩра салагон, Мураҭ иаӷан дгыланы аҭак шыҟаиҵоз еиԥш, акы ианиазҵаауаз.	и писал, как Мурат Яган просто стоял и отвечал, когда его спрашивали.
Ахыҵхырҭеи ауаҩи ари реимадара ныҟәызго маҷӡоуп,	Вот эта связь с источником, наверное, дана некоторым людям,
саргьы Иаӷан иԥхьара саналага, уи аимадара сцәа ианырит	и когда я стал читать Ягана, я вдруг почувствовал это родство
сырҿиара иадкыланы.	в подходе к своему творчеству.
Иара изгьы ирҿиара – «Аамысҭа Қьабза» ауп,	И для него творчество – это его «Аамста Кябза»,
ауаа рзы иаԥҵоу. Абри аҩыза аиҿырԥшра шана,	которая создана для людей. Вот это поразительное совпадение,
шәзеиԥш хыҵхырҭа здыруа иузгәакьоу адоуҳатә ԥстәык анырра,	узнавание родственного, духовного существа, которому известен один общий источник,
иареи сареи ҳазныз иарбан аамҭазаалакгьы, иарбан ҭыԥзаалакгьы ҳахьынхоз,	несмотря на то, в каком время мы с ним жили, в каких местах
егьа ҳаиҟәыҭхазаргьы: аҭагылазаашьақәа, аҭоурых, агеографиа рыла.	мы жили, как бы не были разделены: обстоятельствами, историей, географией.
Егьа ус акәзаргьы, уи сареи ҳаизгәакьахеит. Уи иџьашьахәу метафорак имоуп.	Тем не менее, мы оказались с ним родственными. У его есть поразительная метафора.
Абар, зхыб кылжәоу ажәытә ҩны, иҳәеит,	Он говорит, вот старый дом с продырявленной крышей,
ахыб икылсны амра ашәахәақәа аҩны лашьца иҩнаҷҷоит.	и прорывается в темноту помещения от солнца много лучей.
Урҭ рахьтә иарбан шәахәоу иаанукылалакгьы,	Стоит любой из этих лучей поймать,
алашара ахыҵхырҭа убоит. Уахьынтәиԥлакгьы,	и ты увидишь источник света. Из любой точки будешь смотреть,
уара иубоит ауаа зегьы ишырбо еиԥш, –	ты увидишь то же самое так же, как и все люди, –
алашара хыҵхырҭак аҳасабала. Иџьашьахәу формулоуп.	один источник общий. Поразительная метафора.
Абри аҩыза абзазаратә ҿырԥштәала акрызҵазкуа аформула ааирԥшит,	Так просто, на бытовом уровне такую великую формулу объяснил,
иагьирҵабыргит азеиԥш хьышьҭра шыҟоу. Ари шаноуп,	что есть общий источник. Это поразительное дело,
уаҩԥсык иаҳасабала сарлахҿыхуеит, еснагь иҟало акы	ободряющее меня, как человека, что я приобщен к тому,
саргьы сахьалахәу азы.	что будет всегда.
Уи алашара ақәгара, мамзаргьы арцәара ауӡом.	И этот свет нельзя убрать и погасить.
Уара уи ахыҵхырҭа уатәызар,	Если ты прилежишь к этому началу,
уԥсҭазаараҿы зегьы иашахаҭоуп.	то все правильно в твоей жизни.
Абри аҩыза ақәгәыӷра сызирхынҳәит саргьы.	Вот эту уверенность он мне тоже вернул.
Сара арахь сҩыза иахь ауп сахьаауаз, апандемиа аныҟала дсымбацызт,	Хотя, я сюда ехал к другу своему, началась пандемия,
ишҟагьы сзаауамызт, ара цәыббразы аҳәаа аадыртаанӡа,	и долго я не мог к нему попасть, пока здесь не открыли в сентябре,
усҟан ауп санааи, сахьааизгьы ыцхыраара ду сауит.	я только тогда смог приехать, и здесь я нашел мощную поддержку.
Санаауаз, сҭагылазаашьа хьанҭан.	Я уезжал оттуда в очень тяжелом состоянии.
Сара еснагь схы сазҵаауан,	Я всегда спрашивал себя,
избан сырҿиара акалашәа изыҟоу?	почему у меня творчество такое странное?
Избан арационалра зсылам? Издыруеит, гәыԥҩык ашәҟәыҩҩцәа ирҳәақәо,	Почему я не рационален? Я знал, что многие писатели говорят,
материал гәарҭак ҭысҵааит, акырӡа сгәы иҭасыҩхьеит ҳәа.	я гору материала изучил, столько всего выписывал в сердце.
Толстоигьы ирацәаны аматериал ҭиҵаауан. еилырганы аматериал рацәоуп.	Даже Толстой много изучал материала.
Сара, иахьысҳәо сацәыԥхашьоит аха, акгьы ҭысҵааӡомызт. Сара исымоуп ароман дуқәа, иаҳҳәап «Абна-аб» еиԥш иҟоу,	А я, к стыду своему, ничего не изучал. У меня есть большие романы такие, как «Отец-лес»,
аметафизикатә планԥшра змоу, иаҳҳәап «Џьанаҭ агәырӷьарақәа»,	большие романы метафизического плана, как «Радости Рая»,
«Иона адгьылбжьаха».	«Остров Ионы».
шәара шәҟны урҭ рыӡбахә аӡәгьы имаҳац,	У вас тут никто даже не слышал о них,
избанзар, арҭ ашәҟәқәа ҭыҵит, аха аԥхьаҩцәа иргахьеит.	потому что эти книги у меня изданы, но они не разошлись.
Убри аҟынтә, сара уи аҩыза аметод сымоуп анысҳәо,	Поэтому, когда я говорил о том, что у меня такой метод, то
Москва аӡәырҩы ргәы сзыԥжәон.	многие в Москве сердились на меня.
Зны ааԥхьара сырҭит Ажәларқәа реиҩызара ауниверситет ашҟа,	Однажды меня пригласили в университет Дружбы народов,
уаҟа иаахтны исҳәеит ахаангьы аматериал шҭысымҵаауа,	и я там посмел признаться, что я никогда не изучаю материалы,
зҽызыԥсахуа ахдырра ала аҭагылазаашьа сҽақәыршәаны ишызыҩуа атәы,	что я пишу сразу в состоянии измененного сознания,
сроман ду аҿы шаҟа персонажцәа ҟало шысзымдыруагьы.	я не знаю сколько у меня будет персонажей в моем большом романе.
Афранцыз еиҭагаҩцәа ирыԥхьаӡеит,	Переводчики французские посчитали,
сроман «Аб-абна» аҟны 500 ҩык инареиҳаны аперсонажцәа шалоу.	что в моем романе «Отец-лес» 500 с лишним персонажей.
Хаҭала сара исыздыруамызт аперсонажцәа шаҟаҩы ыҟаз, ус ауп сара аус шызуаз.	Я даже не знал сколько у меня персонажей, то есть я работал именно вот так.
ахыҵхырҭа аҿаԥхьа сыҽкажьны аус зуан,	Я работал, припадая к источнику,
уи атәы Урыстәыла исызҳәомызт, аха Ажәларқәа реиҩызара ауниверситет аҟны ианысҳәа,	и в этом я даже не мог признаться в России, когда я сказал об этом в университете Дружбы народов,
зҽаԥсазтәыз профессорк, кафедрак анапхгаҩы,	одна заслуженный профессор, чуть ли не зам. зав. кафедры чего-то
лгәы сзыԥжәеит:	на меня рассердилась:
«Зыхдырра аҽаԥсахуа аҭагылазаашьа шәҽақәыршәаны аус жәуазар, уа шәыҟаз» лҳәеит.	«Ну, если вы работаете в состоянии измененного сознания, оставайтесь там».
Сара лҿаԥхьа аҭамзаара шьҭасҵеит, иҟасҵари, слахьынҵа ус иҟоуп сҳәеит.	Я перед ней извинился, сказал, ну, что делать, такова моя судьба.
Сара араҟа исоуит сырҿиара зырҵабыргуа,	Я здесь получил подтверждение своему творчеству,
ахыҵхырҭа сахьалахәу зҳәо. Иаӷан имыҩуеи, ауаа ахьыҟазаалакгьы,	что я приобщен к источнику. Яган же пишет, что люди где бы они ни были,
ахыҵхырҭа иалахәызар ҟалоит, хаҭала урҭ зынӡа еиԥшымзаргьы.	если они приобщены к источнику, они могут совершенно быть разными.
Ара раԥхьаӡа ахәыцра салагеит,	Тут я впервые стал размышлять,
сҩызцәа рызҵаара сҽазыскит,	стал спрашивать у своих друзей,
Руслан сзабаирдырыз. Урҭ иаԥсоу уаауп, аҵарадырра рымоуп,	с которыми меня познакомил Руслан. Это люди достойные, образованные,
Аԥсны амаҵзура дуқәа ааныркылахьеит. Сразҵаауа салагеит,	занимавшие высокие должности в Абхазии. Я у них стал спрашивать,
избан, уи иӡбахә зышәзымдыруеи?	а почему у вас он неизвестен?
Избан Урыстәыла ҳара ҳҟны уи иӡбахә заҳмаҳац,	Почему у нас в России о нем ничего не слышали,
избан ишәҟәы англыз бызшәахьтә аурысшәахь изеиҭагоу?	почему его книга переведена с английского на русский?
Избан иара англыз бызшәала дзыҩуааз?	Почему он на английском написал?
Арҭ азҵаарақәа аҩызцәа инагӡаны аҭак рзыҟаҵомызт.	На эти вопросы друзья не могли мне ответить сполна.
Сара абри азхәыцра салагеит,	Я стал размышлять об этом,
уи аҩыза алкаақәагьы ҟасҵеит,	и пришел к таким выводам,
Аамысҭа – аамысҭатә дырроуп, традициоуп уҳәар ҟалоит.	что Аамста – дворянское знание, традиция, можно сказать.
Изакәызеи атрадициа? Ари абиԥарала иеимырдо дырроуп.	А что такое традиция? Это знание, передающиеся из поколения в поколение.
Қьабза уи иоуит иеиҳабацәа рҟнытә. Мураҭ Иаӷан ишәҟәаҿы иҳәеит,	Кябза он получил от своих старшин. Мурат Яган рассказал в своей книге,
акрызҵазкуа аамысҭатә хылҵшьҭра Аамысҭа дшалиааз,	что он родился высокородном дворянском роду Аамста,
уи иаб ажәлар раԥхьагылаҩ шиакәыз,	его отец был предводителем народа,
иаргьы иаб иҟынтә уи ахьӡ иҭынхар шакәыз.	и он должен был унаследовать от отца это же звание.
Убри аҟынтә, уи Қьабза аҵаразы амҩақәҵаҩцәа – аиҳабацәа (аталыкцәа) дрыҭан,	Поэтому он был отдан на обучение Кябза своим наставникам – старейшинам (аталыкам),
даргьы зны Қьабза иалааӡаны иахьыҟаз азы.	которые тоже когда-то были воспитаны в знании Кябза.
Уи еиҭеиҳәеит даныхәыҷыз инаркны дшазыҟарҵоз	И он рассказывал, как с детства его готовили
ахаҭара алагамҭа иаҵанакуа	к восприятию реализации
алшарақәа зегьы, амахашьахатә, ахәыцратә уҳәа,	всех своих возможностей, физических, умственных,
анагӡаразы ахшыҩдкылара.	относящихся к началу над личным.
Даҽакала иаҳҳәозар, иҩныҵҟа ауаҩы иаартра,	То есть к открытию в себе человека,
наунагӡа, ес-аамҭа зегьы зыжәлар иртәу ауаҩы,	который навсегда, на все времена будет принадлежать своему народу,
даҽакала иаҳҳәозар, ахаҭара ду. Хаҭала иԥсрагьы	то есть большую личность. И смерть его личная,
иара ишьҭахьгьы иара дааннажьуеит.	оставит все равно его после нее.
Уи даанхеит, аха шәахәаԥш уи дшаанхаз,	Он сам остался, но вы смотрите, как он остался,
аԥхьа Ҭырқәтәылаҟа дцар акәхеит,	он вынужден был уехать сначала в Турцию,
уантәи Европа, уа аҵара иҵаразы,	оттуда в Европу, там получить образование,
анаҩс Канада дақәшәеит, англыз бызшәала	а потом попал в Канаду, и там на английском языке
«Аамысҭа Қьабза» апринцип хадақәа рыҩра далагеит.	он впервые начал записывать основные принципы «Аамста Кябза».
Шәахәаԥш иалҵуа,	Смотрите, что получается,
уи арҭ адыррақәа аԥсуа бызшәала иеиҳабацәа рҟнытә иоуит,	он получил эти знания на абхазском языке от своих старшин,
дара иара ицын ауниверситет данҭазгьы,	они даже сопровождали его во время учебы в университете,
аиҳабацәа ауниверситет ахыбра иаҭаауан,	старшины приходили к зданию университета,
амардуан иаҿатәаны, аҵара даналго ҳәа изыԥшлон,	сидели на ступеньках, ждали когда он там закончит,
анаҩс дыргон, дагьоурыжьӡомызт шырҳәало еиԥш.	потом его забирали и не выпускали, как говорится.
Данқәыԥшыз,	В юности
уи аханатә «Аамысҭа Қьабза» мап ацәикхьан,	он сначала отказался от Аамста Кябза,
насгьы иҟьалаз аԥа иеиԥш адунеи дықәын. Канада џьара даннанага,	и как блудный сын он бродил по свету. Оказавшись где-то в Канаде,
ихыҵхырҭа «Аамысҭа Қьабза» дазыхынҳәит.	он вернулся к Аамста Кябза, к своим истокам.
Аха идыррақәа англыз бызшәала мацара акәын раарԥшра шилшоз.	Но уже мог выражать свои знания только на английском языке.
Ишалҵуа ала, аԥсышәала иоуз адыррақәа,	Выходит, что сведения, полученные им на абхазском языке,
уи ихдырраҿы англыз бызшәахь еиҭеигеит,	он в своем сознании перевел на английский язык,
даҽакала иуҳәозар, даҽа бызшәак ахь иеиҭаган. Уажәшьҭа, шәахәаԥш, закәытә лахьынҵоу,	то есть совершен был перевод на другой язык. А теперь, смотрите, судьба какая,
англыз бызшәа аҟнытә, Аамысҭа Қьабза аԥсуа «ҭаацәеи» Мураҭ Иаӷани ирыбзоураны,	с этого английского, благодаря абхазским «родителям» Аамста Кябза
еиҭа аурыс бызшәахьы еиҭаргеит, аха макьана аԥсшәахь еиҭагатәуп.	и Мурату Ягану снова перевели на русский язык, но еще предстоит перевод на абхазский.
Ари зазгәасҭаз уи ауп, адоуҳатә дыррақәа реиқәырхара,	Я почему об этом говорю, потому что сохранение духовных знаний,
мамзаргьы, адоуҳатә енергиа иашахаҭа, ажәлар рдоуҳатә енергиа	точнее подлинной духовной энергии, духовной энергии народа и
аарԥшра рылшоит уи ажәлар рбызшәа ала мацара,	передачи его возможно только через язык этого народа,
убри аҟынтә даара ихадоуп уажәы уи аҟаҵара. Сара саԥсыуам, слахьынҵа уадаҩоуп,	поэтому чрезвычайно важно сейчас это сделать. Я не абхаз, у меня сложная судьба,
сара скореецуп, аха сара соурыс шәҟәыҩҩхеит, аха уи иҷыдоу ҭоурыхуп.	я кореец, но я стал русским писателем, но тут особая история.
Сара еилыскаауеит ажәлар рдоуҳатә енергиа иашахаҭа аазырԥшуа абызшәа зыԥсоу.	Я понимаю, чего стоит язык передачи подлинной духовной энергии народа.
Ажәлар раенергиа, афымцамч згәылсуа аелектронқәа иреиԥшуп.	Энергия народа имеет сходство с электронами, передающими электрическую энергию по проводникам.
Абызшәагьы убас ауп, ажәлар ренергиа агәылсуеит,	Так и язык народа способен передавать энергию народа,
уи аенергиа алагамҭа ҵаулагьы зыдҳәалоу абызшәоуп.	и самое глубочайшее начало этой энергии связано с языком.
Мураҭ Иаӷан иқәыԥшраан иеиҳабацәа ирымҭазҭгьы арҭ адыррақәа,	Не передай старшины в молодости Мурату Ягану на абхазском языке
мҩас имааз уи Канада дахьыҟаз?	вот это учение, чем бы мог он в Канаде орудовать?
Уи адырра игеит абызшәа иацны,	Он унес это знание с языком и перевел
насгьы, ахыҵхырҭа Қьабза иаԥсуа дырра	это свое, абхазское знание источника Кябза
англыз бызшәахьы иеиҭеигеит. Ижәбама закәытә ҭоурыху,	на английский язык. Видите, какая история,
уажәшьҭа сара исыздыруам шәара шәҟны ишыҟоу аха,	и теперь я не знаю, как у вас,
аха Урыстәыла, иаҳҳәап, абызшәа ацәыӡ ду амоуп.	но в России, например, большая потеря языка.
Сара атәымуаҩуп, сара скореецуп, урыс бызшәала аҩра иалагазгьы среиуоуп,	Я посторонний человек, я кореец, который стал писать на русском языке,
уи шыҟалаз атәы ҭоурых ҷыдоуп,	тоже особая история, как это получилось,
аха сара маҷ-маҷ иҵыхәтәантәиим урыс шәҟәыҩҩны сшьақәгылеит. Алитературатә сахьаркыратә бызшәаҿы,	но я постепенно стал не последним русским писателем. В художеством литературном языке
иаахҵәаны исҳәар сылшоит,	смело могу сказать,
сара асахьаркыратә литература абызшәатә корифеицәа дуқәа рыгәҭаны сыҟоуп.	что я среди самых больших языковых корифеев художественной литературы.
Исҳәар сылшоит, абызшәа аиқәырхара шаҟа аҵанакуа,	И могу сказать, насколько важно сохранить язык,
жәлар ренергетика иадҳәалоу.	связанный с народной энергетикой.
Сара исыздыруа шәара шәҿы аԥсуа бызшәа аҭагылазаашьа.	Я не знаю, какие у вас положения с абхазским языком.
Ауадаҩра дуқәа.	Большие сложности.
Урыстәыла ишыҟоу еиԥш акәхап. Америка атәылаҿы ишыҟоу еиԥш,	Наверное так же, как и в России. Так же, как и в Америке,
англыз бызшәа Америка иабыхшәаны иахьыҟалаз.	где английский язык американским стал.
Ари акультурологиатәи, аонтологиатәи лагамҭақәа ирыдҳәалоу	Это языковое падение,
абызшәатә каҳароуп.	связанное с культурологическими началами, онтологическими началами.
Ари адунеизегьтәи цәырҵроуп, убри азоуп	Это явление всемирное, поэтому происходит
ауаҩытәыҩса идоуҳатә мчы зыӡуа, адәныҟатәи аенергиақәа ирыдҳәалоу,	потеря духовной энергии человечества, сосредоточенная на энергиях чисто внешних,
интеллектла, дыррала,	которые обеспечиваются интеллектом, знаниями,
ҭҵаарадыррала, ауаатәыҩсатә ԥышәа апозитивтә зыҟазаашьақәа. апозитивтә знеишьақәеи ауаҩытәыҩсатә ԥышәахь.	наукой, позитивными подходами к человеческому опыту.
Убри аҟынтә адоуҳара ацәыӡра – ари аԥсҭазаара аенергиа арӡроуп.	Поэтому потеря духовности – это потеря энергии жизни.
Уи адоуҳара абызшәа иалахәуп.	Эта духовность выражается и воплощается в языке.
Иҭабуп ҳәа шәасҳәарц сҭахуп,	Я хотел бы вас поблагодарить,
иҭабуп аинтерес зҵоу абри аҩыза аицәажәара азы.	спасибо за такую интересную беседу.
Аԥсуа ҿар рышҟа иҟашәҵаз ааԥхьаразы иҭабуп,	Спасибо за тот посыл, который вы сделали абхазской молодежи,
уи ахыҵхырҭа адәныҟа акәӡам, ахатә культура аҟны ауп иахьыԥшаалатәу,	что источник не надо искать вовне, а надо искать в своей культуре,
ахатәы бызшәаҿы.	в своем языке.
Ихадоу, шәара ишәымоу ииашахаҭоу алагамҭа «Аамысҭа Қьабза». Амала, уи еиҭархынҳәтәуп.	Главное, вы имеете такие подлинные, убедительные начала, как «Аамста Кябза». Только надо его снова вернуть.
Иҭабуп идуӡӡаны, иҭабуп аицәажәаразы.	Спасибо вам большое, спасибо за беседу. 
	
