За что мы благодарны Иегове?	Избан ҳара Иегова иҭабуп ҳәа зиаҳҳәо?
К какому выводу пришли тысячи братьев и сестер на конгрессе 1935 года и почему?	Еилыркаазеи аишьцәеи аиҳәшьцәеи аӡәырҩы 1935 шықәсазы имҩаԥысыз аконгресс аҿы?
Как благодаря Воозу Ноеминь и Руфь обрели радость?	Ишԥаиргәырӷьеи Вооз Ноемини Руфи?
Как вас ободряет пример юных христиан?	Шәгәы шԥашьҭырхуеи шәеизараҿы иҟоу аҿар?
Как Иегова помог Павлу через Аристарха и Луку?	Дышԥаицхрааи Иегова Павел Аристархи Лукеи рыла?
Как Иегова руководит своей организацией? Приведите примеры.	Напхгара шԥаиҭо Иегова иахьа иорганизациа? Иаажәга аҿырԥштәқәа.
Как можно ненароком обескуражить не состоящих в браке христиан?	Ргәы дзырхьыр алшозеи аҭаацәара иалам ақьырсианцәа?
Как пример Иеговы учит нас делиться с другими своими обязанностями?	Иҿаҳҵаар ҳалшозеи жәҩантәи Ҳаб?
Как родители могут помогать детям быть в истине?	Иҟарҵар рылшозеи аҭаацәа рхәыҷқәа аҵабырг ахаангьы иаанырмыжьырц азы?
Как святой дух помогал последователям Иисуса?	Ишԥарыцхраауаз иԥшьоу адоуҳа Иисус иҵаҩцәа?
Какая прекрасная надежда есть у служителей Иеговы?	Изықәгәыӷуазеи Иегова имаҵзуҩцәа?
Какими методами проповеди пользовалась организация Иеговы в прошлом и какими пользуется сейчас?	Иарбан методқәоу рхы иадырхәоз Иегова иорганизациаҿы ауаа зегьы ажәабжь бзиа рыладырҵәаларц азы?
Какое отношение слова из Экклезиаста 11:6 имеют к проповеди благой вести о Царстве?	Ишԥадҳәалоу Екклезиаст 11:6 иану ажәабжьҳәаратә ус?
Какой у нас должен быть настрой?	Ҳзызхиазар ҳахәҭоузеи ҳара?
Какой урок Павел никогда не забывал?	Ихаимыршҭуази Павел ахаангьы?
Кто может помочь изучающему Библию вырасти духовно и принять решение креститься?	Ицхраауада ауаҩы доуҳала аизҳара?
От каких жизненных трудностей Иегова не стал ограждать своего Сына?	Дызцәимыхьчазеи Иегова Иԥа?
Почему библейские истины так ценны?	Избан Абиблиа иану аҵабыргқәа рыхә зыҳараку?
Почему всех христиан должно интересовать небесное воскресение?	Избан ақьырсианцәа зегьы жәҩантәи аԥсҭалара аинтерес рымазар зрыхәҭоу?
Почему именно сейчас так важно проповедовать?	Иарбан иҷыдоу мзызу ажәабжь аҳәаразы иҳамоу?
Почему мир ненавидит последователей Иисуса?	Избан ауаа ҳзырцәымӷу?
Почему нам важно развеивать свои сомнения?	Избан иҳазцәырҵуа алакҩакрақәа ҳаӡбалар закәу?
Почему нам нужно радушно приветствовать изучающих Библию на наших встречах?	Избан аизарақәа рахь аныҟәара иалаго ауаа гәыкала ҳарԥылалар зҳахәҭоу?
Почему наша вера становится крепче в испытаниях?	Ишԥаныруеи аԥышәарақәа ҳагәрахаҵара?
Чему вас учат слова Марли и Бенджамина?	Ишәнарҵозеи Марлии Бенџьамини рҿырԥштәы?
Чему вас учит пример Аристотелиса и Элени Апостолидис?	Ишәдырҵозеи аиашьа Аристотелис иԥҳәыси иареи рҿырԥштәы?
Чему вас учит пример Ясмин?	Иаҳнарҵозеи Иасмин лҿырԥштәы?
Что поможет нам получать радость от служения, даже если люди не интересуются благой вестью?	Ишәыцхраар алшозеи амаҵзура аҟынтә агәырӷьара аиура, ауаа уиаҟара имӡырҩуазаргьы?
Что произошло с Иосифом в юности?	Дзықәшәазеи иқәыԥшыз Иосиф?
Что происходило в день казни Иисуса?	Изеиԥшрази аҭагылазаашьа Иисус аҵыхәтәантәи иажәақәа аниҳәоз?
Биография. Иегова сделал мои пути прямыми	Абиографиа. Иегова сымҩа ириашоит
Биография. «Сейчас я не мыслю себя без служения!»	Абиографиа. «Уажәшьҭа ажәабжьҳәара бзиа избоит!»
Благодаря чему ваши молитвы на изучении Библии будут конкретными?	Иҟашәҵар шәылшозеи шәынцәаиҳәара ауаҩы игәаҵанӡа инеирц азы?
Благодаря чему можно оживить библейский рассказ?	Иҟаҳҵалар ҳахәҭоузеи Абиблиаҿы ҳзыԥхьо ҳгәаҵанӡа инеиларц азы?
Будьте сильными! Укрепляйте свою веру	Шәҽырӷәӷәаны шәыҟаз! Шәыгәрахаҵара шәырӷәӷәала
В достоверности каких основополагающих истин вам нужно убедиться?	Иарбан ихадоу ҵабыргқәоу зыгәра ганы шәыҟазар шәыхәҭоу?
В каких ситуациях нужно вступаться за сестер? Приведите пример.	Ианбаҭаххар алшо аиаҳәшьа лыхьчара? Иаажәга аҿырԥштәы.
В каких ситуациях сестрам может понадобиться наша помощь?	Иарбан цхыраароу аиҳәшьцәа ирҭаххар алшо?
В какой ситуации находился Павел?	Иарбан уадаҩроу Павел дызҭагылаз?
В каком случае друг может предостеречь вас?	Ианбашәҭаххар алшо шәҩыза иҟынтә ариашара?
В каком случае Евангелия по-настоящему нам помогут?	Иҟаҳҵалар акәзеи Аевангелиеқәа ирну хәарҭа ҳзааргаларц азы?
В любых обстоятельствах «имейте веру в Бога»	Еиуеиԥшым аҭагылазаашьақәа рҿы «Анцәа ихаҵара шәымаз»
«В твои руки вверяю мой дух».	«Сыԥсы Унапы ианысҵоит».
В чем был уверен Иисус, согласно Луки 23:46?	Зыгәраганы дыҟази Иисус, Лука 23:46 иану инақәыршәаны?
В чем был уверен Иоанн?	Зыгәра ганы дыҟази Иоанн?
В чем еще выражалась любовь Иоанна к братьям и сестрам?	Ишԥааирԥши Иоанн иашьцәеи иаҳәшьцәеи бзиа ишибоз?
В чем еще мы можем брать пример с Иисуса?	Ишԥаҳалшо уаҳа Иисус иҿыԥшра?
В чем мы можем быть уверены?	Зыгәра ганы ҳаҟазар ҳалшозеи ҳара?
В чем мы можем быть уверены, если не даем отдыха своей руке?	Ҳаззыԥшызар ҳалшозеи ҳара, ҳнапы ԥсшьаха аҳамҭалар?
В чем нам нужно быть уверенными?	Зыгәра ганы ҳаҟазар ҳахәҭоузеи ҳара?
В чем превосходство закона Христа?	Избан Христос изакәанԥҟара еиҳа изеиӷьу?
В чем проявляется смирение Иеговы?	Ишԥааирԥшуеи Иегова ахынраалара?
В чем проявлялась скромность Даниила?	Ишԥааирԥши Даниил ахынраалара шилаз?
В чем проявлялось смирение Иисуса?	Ишԥааирԥшуаз Иисус ахынраалара?
В чем Синди находила радость во время тяжелой болезни?	Илыцхраазеи Синди агәырӷьара ахьчара?
Воскресит ли Бог Адама? Объясните.	Иԥсы ҭеиҵома Анцәа Адам? Иҳаилшәыркаа.
Время от времени оценивать духовные успехи изучающего	Аамҭа-аамҭала доуҳала деизҳауоу-деизымҳауоу гәашәҭала
Всегда держите свой взор на Иегове	Иегова еснагь шәылаԥш иқәкыз
Всегда ли Иоанн относился к другим с любовью?	Иааирԥшуазма Иоанн еснагь абзиабара?
Всей семьей служить подсобными пионерами, когда собрание посещает районный надзиратель	Шәеизара араионтә хылаԥшҩы данаҭаауа, шәшынҭаацәоу ицхырааҩу пионерс амаҵ аура
Вы важны для собрания Иеговы!	Аизараҿы инашәыгӡо аус Иегова изы ахә ҳаракуп!
Готовиться к каждому занятию	Еснагь абиблиатә ҵара иҽазыҟаиҵалароуп
Готовы ли вы и дальше исправляться?	Шәазхиоума шәара анаҩсгьы аҽыԥсахра?
Готовы ли вы стать «ловцами людей»?	Шәазхиоума шәара «уаакцәаҩны» аҟалара?
Давать слово Библии	Абиблиа ацәажәаразы алшара ашәҭ
Дело подготовки учеников приносит радость братьям во всем мире	Аҵаҩцәа разыҟаҵара аус адунеи зегь аҿы аишьцәа агәырӷьара рзаанагоит
Зачем Аса укреплял свое войско?	Избан Аса ир зирӷәӷәоз?
Знаете ли вы? Как древняя надпись подтверждает достоверность Библии?	Ижәдыруама шәара? Ишԥашьақәнарӷәӷәо ажәытә напынҵамҭа Абиблиа агәра агара ишаԥсоу?
Из-за чего мы можем пасть духом? Что мы обсудим в этой статье?	Избан ҳгәы каҳар залшо? Еилҳаргозеи ари астатиаҿы?
Из-за чего нас может охватить тревога?	Иҟалар алшозеи агәҭынчымра ҳҽаҳҭар?
Из-за чего один левит стал чувствовать себя подавленным?	Избан алевитцәа иреиуаз аӡәы игәы зкаҳаз?
Из-за чего Петр мог чувствовать себя подавленным?	Игәы казыжьуази Пиотр?
Изучать каждую неделю	Абиблиа есымчыбжьа иҭиҵаалароуп
Исполняйте закон Христа, когда вас не видят другие	Инашәыгӡала Христос изакәанԥҟара, аӡәгьы шәанимбо
Исполняйте закон Христа, когда проповедуете	Инашәыгӡала Христос изакәанԥҟара, ажәабжь бзиа анышәҳәо
К чему вас побудила эта статья?	Шәгәы зызҭанаҵазеи шәара ари астатиа?
К чему нас побуждают слова из 2 Тимофею 4:1, 2?	Ҳгәы зызҭанаҵозеи рҵаҩцәак раҳасабала 2 Тимофеи иахь 4:1, 2 иану?
К чему побуждала Иоанна любовь?	Игәы зызҭанаҵози Иоанн абзиабара?
Каждый день общаться с Иеговой	Есыҽны Иегова диацәажәалароуп
Как Анри справился с чувством подавленности?	Ицхраазеи Анри агәкаҳара аиааира?
Как братья в России пользовались периодом спокойствия?	Рхы ишԥадырхәоз Урыстәыла инхо ҳашьцәеи ҳаҳәшьцәеи аҭынчра аамҭа?
Как братья и сестры в одной стране проявляли друг к другу любовь во время войны?	Ишԥаадырԥшуаз аишьцәеи аиҳәшьцәеи бзиа ишеибабоз аибашьра ахьцоз тәылак аҿы?
Как ваш пример может помочь изучающему и дальше расти духовно?	Ицхраар шԥалшо ҳҿырԥшы Абиблиа зҵо ауаҩы?
Как ваше поведение может повлиять на изучающих Библию?	Инырыр шԥалшо ҳхымҩаԥгашьа Абиблиа зҵо ауаҩы?
Как вера побуждает нас проповедовать?	Ишԥаҳацхраауеи ҳагәрахаҵара ажәабжь аҳәара?
Как верные друзья помогают нам стать ближе к Иегове?	Ишԥаҳацхраауеи аҩызцәа бзиақәа Иегова изааигәахара?
«Как воскресают мертвые?»	«Аԥсцәа рыԥсы злаҭалоузеи?»
Как вы можете применить принцип из Притч 20:18, когда вас приглашают на изучение Библии?	Ишԥашәылшо Ажәамаанақәа 20:18 иану апринцип шәхы иашәырхәар, аӡәы абиблиатә ҵарахьы шәанааиԥхьо?
Как глава семьи может заботиться об эмоциональных потребностях домашних?	Ишԥаилшо аҭаацәара ахада иҭаацәа ремоциатә ҭахрақәа дышреиҷаҳауа ааирԥшыр?
Как главы семей могут подражать смирению Иеговы и Иисуса?	Ишԥарылшо аҭаацәара ахадацәа Иеговеи Иисуси ирҿыԥшны ахынраалара аарԥшра?
Как готовиться к каждому занятию?	Ишԥашәылшо абиблиатә ҵарақәа ибзианы рҽырзыҟаҵара?
Как Давид мог бы поступить в сложившейся ситуации?	Ихы мҩаԥигар шԥалшоз Давид дзықәшәаз ауадаҩраҿы?
Как Давид поступил в трудной ситуации?	Ихы шԥамҩаԥигеи Давид ауадаҩра данҭагыла?
Как Давиду помог Иегова?	Дышԥаицхрааи Иегова Давид?
Как еще вы можете помочь изучающему Библию почувствовать себя частью собрания?	Иҟашәҵар шәылшозеи иҵегьы ауаҩы аизара дшахәҭаку ибарц азы?
Как еще мы можем помогать сестрам?	Иҟаҳҵалар ҳалшозеи уаҳа ҳаҳәшьцәа ҳрыцхрааларц азы?
Как еще нам помогает Иегова?	Дышԥаҳацхраауеи Иегова иҵегьы?
Как Иегова вас защищает?	Ҳашԥеихьчо ҳара Иегова?
Как Иегова и Иисус проявляют к нам свою любовь?	Ишԥаадырԥшуеи Иеговеи Иисуси ҳара ҳахь ирымоу абзиабара?
Как Иегова помог Павлу?	Дышԥаицхраауаз Иегова Павел?
Как Иегова помог Павлу через Иисуса?	Дышԥаицхрааи Иегова Павел Иисус ила?
Как Иегова помогал Павлу через братьев и сестер?	Дышԥаицхраауаз Иегова Павел аишьцәеи аиҳәшьцәеи рыла?
Как Иегова проявил терпение к Аврааму и Сарре?	Ишԥааирԥши Иегова ачҳара Авраами Сарреи рахь?
Как Иегова спасет свой народ во время великого бедствия?	Ишԥеиқәирхо Иегова ижәлар арыцҳара ду аан?
Как Иегова учит нас на примерах других людей?	Аҵара шԥаҳирҵо Иегова Иажәа ала?
Как Иисус помог Петру справиться с подавленностью?	Дышԥаицхрааи Иисус Пиотр агәкаҳара аиааира?
Как Иосифа могли утешать его пророческие сны?	Игәы шԥашьҭырхуаз Иосиф иибахьаз аԥхыӡқәа?
Как каждый из нас может восхвалять Бога и Христа на Вечере воспоминания?	Иааҳарԥшыр шԥаҳалшо Ахәылԥаз аҿы Иеговеи Иисуси иаҳзыҟарҵаз ахә шаҳшьо?
Как любовь к Отцу укрепила Иисуса?	Излаицхраазеи Иисус Иаб иахь имаз абзиабара?
Как многие люди одержат победу над смертью?	Ишԥаиааиуеи аԥсра доуҳала иалху ақьырсианцәеи Анцәа изиашоу егьырҭ ауааи?
Как можно развивать свои учительские способности?	Иҳацхраауазеи ҳмаҵзура аиӷьтәра?
Как молодые братья могут помогать другим христианам?	Ирыцхраалар шԥарылшо иқәыԥшу аишьцәа зықәрахь инеихьоу аишьцәеи аиҳәшьцәеи?
Как мы можем ободрять сестер?	Ишԥаҳалшо ҳаҳәшьцәа ргәы ашьҭыхра?
Как мы можем поддерживать неактивных братьев и сестер?	Идҳарбар шԥаҳалшо ихьшәашәаз ҳашьцәеи ҳаҳәшьцәеи ҳашрывагыло?
Как на нас влияет смирение?	Иҟаҳҵалозеи ахынраалара ҳалазар?
Как на нас может влиять уныние?	Изшәарҭоузеи агәкаҳара?
Как нам нужно относиться к браку и безбрачию?	Иаҳҳәар ҳалшозеи аҭаацәалазаареи аҭаацәаламзаареи ирызкны?
Как нам помогает молитва?	Ишԥаҳацхраауеи анцәаиҳәара?
Как нам помогает Слово Бога?	Иҳацхраар шԥалшо Анцәа Иажәа?
Как нам помогают близкие отношения с Иеговой?	Хәарҭас иаҳзаанагозеи Иеговеи ҳареи ҳаиҩызара ӷәӷәа?
Как нам поможет уверенность в истинности библейских учений?	Ишԥаҳацхраауеи Абиблиа шьаҭас измоу ҳагәрахаҵара?
Как научиться быть хорошим главой семьи?	Ицхраауазеи ахаҵа аҭаацәараҿы хада бзианы аҟалара?
Как некоторые мужчины относятся к женщинам?	Ишԥарызныҟәо ахацәа шьоукы рыҳәса?
Как нужно относиться к тому, что Иегова все о нас знает?	Иарбан цәаныррақәоу иҳазцәырҵлар ахәҭоу, Иегова ибзиаӡаны ҳшидыруа ҳаназхәыцуа?
Как о нас заботится организация Иеговы?	Дышԥаҳаиҷаҳауеи Иегова иорганизациа ала?
Как относились к Давиду некоторые люди?	Ишԥаизыҟаз шьоукы Давид?
Как оценить духовные успехи изучающего?	Еилаҳкаар шԥаҳалшо ауаҩы доуҳала деизҳауоу-деизымҳауоу?
Как Павел мог бы поступить в сложившейся ситуации?	Ихы мҩаԥигар шԥаилшоз Павел?
Как Павел поступил в трудной ситуации?	Иҟаиҵози Павел ауадаҩра данҭагылаз?
Как Павлу помог правитель Фест?	Дышԥаицхрааи анапхгаҩы Фест Павел?
Как побудить изучающего регулярно посещать встречи собрания?	Иҟаҳҵар ҳалшозеи Абиблиа зҳарҵо иааиԥмырҟьаӡакәа аизарақәа рахь аныҟәара игәазҭаҳҵарц азы?
Как подготовить изучающего Библию к крещению? Что мы обсудим в следующей статье?	Дышԥазыҟаҵатәу Абиблиа зҳарҵо аҽӡаахра? Еилҳаргозеи анаҩстәи астатиаҿы?
Как помочь братьям и сестрам оставаться в истине?	Иҟаҳҵалар ҳалшозеи ҳашьцәеи ҳаҳәшьцәеи аҵабырг мҩала ацара ҳрыцхрааларц азы?
Как помочь изучающему развить близкие отношения с Иеговой?	Иҟашәҵар шәылшозеи Абиблиа зшәырҵо Иегова иҩызахара шәицхраарц азы?
Как помочь изучающему узнать о качествах Иеговы? Приведите пример.	Ҳицхраар шԥаҳалшо ауаҩы Иегова дзеиԥш Нцәоу аилкаара? Иаажәга аҿырԥштәы.
Как помочь изучающим развить желание проповедовать благую весть?	Иргәаҳарԥхар шԥаҳалшо Абиблиа зҳарҵо ажәабжь бзиа аиҭаҳәара?
Как пример Иисуса помогает нам помнить о важности дела проповеди?	Ишԥаҳацхраауеи Иисус иҿырԥшы ажәабжьҳәаратә ус зегь раԥхьа аргылара?
Как проницательность помогла Дэниелу?	Ишԥаицхрааи Дениел агәеилых бзиа?
Как проявить заботу о неактивных братьях и сестрах?	Иааҳарԥшыр шԥаҳалшо ихьшәашәаз ҳашьцәеи ҳаҳәшьцәеи ҳгәы ишыҵхо?
Как ранние христиане пользовались периодом спокойствия?	Рхы ишԥадырхәоз актәи ашәышықәсазы инхоз ақьырсианцәа аҭынчра аамҭа?
Как реагировал Давид на несправедливое отношение к нему царя Саула?	Иҟаиҵози Давид аҳ Саул ииашамкәа дышизныҟәозгьы?
Как Руфь заботилась о Ноемини, согласно Руфи 1:16, 17, 22?	Лгәы шԥашьҭылхуаз Руфь Ноеминь, Руфь 1:16, 17, 22 иану инақәыршәаны?
Как с помощью собрания Иегова помогает нам сохранять спокойствие и доверять ему?	Ихы ишԥаирхәо Иегова ҳашьцәеи ҳаҳәшьцәеи агәҭынчра ахьчареи игәра агареи дҳацхраарц азы?
Как слова из 1 Иоанна 1:9 помогают нам служить Иегове с чистой совестью?	Ишԥаҳацхраауеи 1 Иоанн 1:9 иану ҳгәы рҭынчны Иегова имаҵ аура?
Как слова из Иеремии 20:8, 9 учат нас бороться с подавленностью?	Ишԥаҳацхраауеи Иеремиа 20:8, 9 иану агәкаҳара аиааира?
Как слова из Псалма 103:13, 14 помогают нам смотреть на свои грехи глазами Иеговы?	Ишԥаҳацхраауеи Аԥсалом 103:13, 14 иану агәнаҳа аныҟаҳҵо Иегова дышҳахәаԥшуа аилкаара?
Как совет из 1 Петра 3:8 помогает нам разумно пользоваться социальными сетями и мессенджерами?	Ишԥаҳацхраауеи 1 Пиотр 3:8 иану абиблиатә лабжьара асоциалтә каҭақәа ииашаны рхархәара?
Как совет не жить прошлым помог нашей сестре?	Хәарҭас илзаанагазеи ҳаҳәшьа ииасхьаз мыцхәы дахьазымхәыцуаз?
Как старейшины могут помочь изучающим Библию?	Иҟарҵар рылшозеи аизара аиҳабацәа Абиблиа зҵо ирыцхраарц азы?
Как терпение помогает нам в служении?	Ишԥаҳацхраауеи ачҳара ҳмаҵзураҿы?
Как эта статья укрепила вашу надежду на воскресение?	Ишԥарӷәӷәеи ари астатиа аԥсҭалара иадҳәалоу шәгәыӷра?
Какая важная деталь содержится в повелении Иисуса?	Иаҳхаҳмыршҭлар ҳахәҭоузеи Иисус идҵа анынаҳагӡо?
Какая возможность есть у Свидетелей Иеговы во многих странах? О чем стоит себя спросить?	Иарбан лшароу иахьа иҳамоу атәылақәа жәпакы рҿы? Иарбан зҵаароу ҳхы иаҳҭар ҳалшо?
Какая опасная точка зрения может ослабить нашу веру в воскресение?	Иарбан ишәарҭоу хәыцшьоу аԥсҭаларахь иҳамоу агәрахаҵара зырԥсыҽыр алшо?
Какие библейские примеры помогут нам сохранять спокойствие, когда мы сталкиваемся с противодействием?	Иарбан ҿырԥштәқәоу агәҭынчра ахьчара иҳацхраауа, аҿагылара ӷәӷәақәа ҳанрықәшәо?
Какие благословения получают многие полновременные служители?	Иарбан зылԥхарақәоу ирымоу заамҭа зегь амаҵзура иазызкуа?
Какие вопросы мы обсудим?	Иарбан зҵаарақәоу еилҳарго?
Какие вопросы мы обсудим в этой статье?	Иарбан зҵаарақәоу ари астатиаҿы ҳазлацәажәо?
Какие вопросы мы рассмотрим?	Иарбан зҵаарақәоу ари астатиаҿы еилҳарго?
Какие вопросы мы сейчас обсудим?	Иарбан зҵаарақәоу ҳара уажәы еилҳарго?
Какие вопросы нам нужно себе задать, принимая во внимание слова из Иакова 3:17?	Иарбан зҵаарақәоу ҳхы иаҳҭар ҳахәҭоу, Иаков 3:17 иану инақәыршәаны?
Какие задания Иисус доверял женщинам?	Иарбан усқәоу Иисус аҳәса ирыдиҵоз?
Какие качества отличали царя Асу в начале его правления?	Иарбан ҟазшьақәоу Аса аҳра аура даналага иааирԥшуаз?
Какие обязанности были у Иоанна?	Иарбан ҭакԥхықәрақәоу Иоанн идыз?
Какие примеры можно найти в Библии?	Иарбан ҿырԥштәқәоу Абиблиа иану?
Какие решения Иисус принимал в юные годы?	Иарбан ихадоу ӡбароу Иисус данқәыԥшыз идикылаз?
Какие решения принимали Иисус и его родители?	Иарбан ӡбарақәоу Иисус иҭаацәеи иареи ирыдыркылоз?
Какие события испытали на прочность доверие Авраама Иегове?	Иарбан ҭагылазаашьақәоу Авраам Иегова иахь имаз агәрагара ԥызшәаз?
Какие у нас есть основания полагать, что мы сможем узнать воскресших?	Избан ҳгәы изаанаго зыԥсы ҭало ҳҭынхацәеи ҳҩызцәеи ҳанырԥыло, ҳара урҭ иаразнак иаҳдыруеит ҳәа?
Какие у нас есть причины выражать нежные чувства к братьям и сестрам?	Иарбан мзызқәоу ҳашьцәеи ҳаҳәшьцәеи рахь абзиабара аарԥшразы иҳамоу?
Какие чувства вызывает у вас любовь Иеговы?	Иарбан цәаныррақәоу Анцәа ибзиабара ишәызцәырнаго?
Какие этапы духовного роста проходит каждый желающий креститься?	Иарбан шьаҿақәоу ауаҩы иҟаиҵар акәу иҽӡааихырц азы?
Каким городом был Ур?	Изеиԥшрази ақалақь Ур?
Каким правом обладают Иегова и Иисус?	Иарбан мчроу Иеговеи Иисуси ирымоу?
Какими инструментами снабдила нас организация Иеговы?	Иарбан мыругақәоу Иегова иорганизациа ала иҳаиҭо?
Какими приемами пользуется Сатана?	Ихы иаирхәозеи Аҩсҭаа ииҭаху ҳирҟаҵарц азы?
Каких мыслей нам нельзя допускать?	Ҳҽызцәаҳахьчалар ҳахәҭоузеи ҳара?
Каких результатов Иегова помог достичь своим служителям?	Иарбан ус дуу Иегова ижәлар рыла инаигӡо?
Какое задание ожидает на небе воскресших помазанников?	Иарбан усу жәҩантәи аԥсҭазааразы зыԥсы ҭаҵахо ақьырсианцәа ирзыԥшу?
Какое решение можно назвать самым мудрым для любого человека?	Иарбан зегь иреиӷьу ӡбароу ауаҩы идикылар илшо?
Какой библейский эпизод мы сейчас рассмотрим?	Иарбан ҭоурыху ҳара уажәы еилҳарго?
Какой важной истине нас учат слова Иисуса о бедной вдове?	Иҳаилнаркаауазеи Иисус иӷарыз аԥҳәысеиба илызкны ииҳәаз?
Какой вопрос может возникать у некоторых из нас?	Иарбан зҵаароу Анцәа имаҵзуҩцәа шьоукы ирызцәырҵыр алшо?
Какой замечательный пример подал Давид?	Иарбан ҿырԥш бзиоу Давид иаҳзынижьыз?
Какой настрой должен быть у брата, когда он получает почетные обязанности?	Иарбан гәазыҟашьоу аиашьа имазар ихәҭоу, иҷыдоу ҭакԥхықәрақәак идырҵозар?
Какой пример использовал в своих письмах апостол Павел?	Иарбан ҿырԥштәу апостол Павел иааигаз исаламшәҟәқәа рҿы?
Какой пример нам подал апостол Павел?	Иарбан ҿырԥшу апостол Павел рҵаҩык иаҳасабала иҳаиҭаз?
Какой пример нам подал Иисус?	Иарбан ҿырԥшу Иисус иаҳзынижьыз?
Какой пример подал нам апостол Иоанн?	Иарбан ҿырԥшу апостол Иоанн иҳаиҭаз?
Какой пример подал нам царь Аса?	Иарбан ҿырԥштәу Аса иаҳзынижьыз?
Какой совет Нейтан Норр дал своей жене?	Иарбан лабжьара бзиоу аиашьа Норр иԥҳәыс илиҭаз?
Какой чести удостоил нас Иегова?	Иарбан ҳаҭыру ҳара иҳаҭәашьоу?
Какому влиянию нам нужно противостоять?	Ҳҽызцәаҳахьчалар ҳахәҭоузеи ҳара?
Какому призыву апостола Павла нам нужно следовать?	Иарбан лабжьароу апостол Павел иҳаиҭаз?
Какую пользу приносит молодым христианам верность библейским принципам?	Хәарҭас ироуазеи иқәыԥшу ақьырсианцәа абиблиатә нормақәа ианрықәныҟәо?
Какую помощь могут оказать сестрам старейшины?	Ишԥарылшо уаҳа аизара аиҳабацәа аиҳәшьцәа ирыцхраалар?
Какую радость может испытать каждый из нас?	Ҳзыргәырӷьозеи ҳара зегьы?
Когда служить Иегове труднее?	Ианбаҳцәыцәгьахар алшо Иегова имаҵ аура?
Краткий обзор «Сторожевой башни»	«Ахьчаратә бааш» иааркьаҿу ахҳәаа
«Люби своего ближнего, как самого себя»	«Бзиа дба иузааигәоу, ухы еиԥш»
Любите Бога, а не мир	Бзиа дыжәбала Анцәа, ари адунеи акәымкәа
Любите Иегову всем сердцем	Иегова гәык-ԥсыкала бзиа дыжәбала
Любовь к Иегове побуждает нас любить братьев по вере	Анцәа иахь иҳамоу абзиабара ҳгәазҭанаҵоит ҳагәрахаҵара ҳацеиҩызшо бзиа рбара
Могут ли несовершенные люди подражать совершенному примеру Иисуса? Объясните.	Иҳалшома инаӡам ауаа инаӡаз Иисус иҿыԥшра? Иҳаилшәыркаа.
Музыкальная видеозаставка	Авидеонҵамҭа зцу амузыка
Мы твердо уверены в воскресении!	Ҳара аԥсҭалара шыҟало агәра ҳгоит!
На что нам нельзя отвлекаться?	Ҳхы ззаҳмышьҭлар акәзеи ҳара?
Находите радость в служении	Шәмаҵзура агәырӷьара шәзаанагалааит
«Не давай отдыха своей руке»	«Унапы ԥсшьаха аумҭалан»
«Не думайте о себе больше, чем необходимо думать»	«Шәызлаҟоу еиҳаны, иахырҟьаны шәхы шәымбан»
Не отягощайте свои сердца	Шәгәы аҭагылазаашьа шәацклаԥшла
Но как развить эти чувства? В этом нам помогут несколько библейских примеров.	Аха иҳацхраауазеи уи аҩыза абзиабара аизырҳара? Шәааи Абиблиа иану ҿырԥштәқәак еилҳаргап.
О какой важной истине сказал в своей речи брат Рутерфорд?	Иарбан зеиԥшыҟам ҵабыргу аиашьа Рутерфорд иажәахә аҿы дызлацәажәаз?
О какой опасности предупреждают нас слова из Экклезиаста 7:10?	Иҟаҳамҵалар ҳахәҭоузеи ҳара Екклезиаст 7:10 иану инақәыршәаны?
О ком мы можем молиться, принимая во внимание слова из Деяний 12:5?	Иззы ҳиҳәалар ҳалшозеи ҳара Анцәа, Аусқәа 12:5 иану инақәыршәаны?
О чем вы можете просить Иегову?	Иҟашәҵар акәзеи Иегова дшәыцхраарц азы?
О чем нужно помнить главе семьи?	Ихаимыршҭлар ихәҭоузеи аҭаацәара ахада?
О чем нужно помнить родителям?	Ирхадмыршҭлар акәзеи аҭаацәа?
О чем позаботился Иегова?	Иҟаиҵазеи Иегова абзиабара аарԥшны?
О чем рассказывается в четырех Евангелиях?	Изызкузеи ԥшь-Евангелиек?
Общаться с Божьими служителями	Анцәа имаҵзуҩцәа шәрыҿцәажәала
Опишите казнь Иисуса.	Иаҳзеиҭашәҳәа Иисус дшыршьыз.
Ответы на какие вопросы мы узнаем из этой статьи?	Иарбан зҵаарақәоу еилҳарго?
По какому критерию Иегова оценивает наше служение?	Иҟаҳҵалар акәзеи Иегова ажәабжьҳәаратә ус аҿы ақәҿиара ҳамоуп ҳәа иԥхьаӡаларц азы?
Побуждать изучающего находить друзей в собрании	Аизараҿы аҩызцәа иԥшааларц игәазҭашәҵала
Подлинная вера приносит щедрые благословения	Ииашаҵәҟьоу агәрахаҵара ирацәаны азылԥхарақәа аанагоит
Подчеркивать важность посвящения и крещения	Анцәа иҽизкреи аҽӡаахреи шхадоу иашәҳәала
Помните самую важную заповедь	Ишәхашәмыршҭлан зегь реиҳа ихадоу аԥҟара
Помочь в обслуживании Зала Царства или Зала конгрессов	Аҳратә зал ма Аконгресстә зал аргылараҿы ацхыраара аҟаҵара
Посещать встречи собрания	Аизарақәа рахь дныҟәалароуп
Послужить неделю на редко прорабатываемой территории	Ажәабжьҳәаҩцәа ахьазымхо аҭыԥ аҿы мчыбжьык амаҵ аура
Почему Аврааму нужно было терпеливо ждать Иегову?	Избан Авраам Иегова дизыԥшлар зихәҭаз?
Почему было бы хорошо пригласить на изучение опытного возвещателя?	Избан изыбзиоу аԥышәа змоу ажәабжьҳәаҩцәа абиблиатә ҵарахьы иааҳаԥхьалар?
Почему важно говорить изучающему о посвящении и крещении?	Избан Абиблиа зҳарҵо Анцәа иҽизкреи аҽӡаахреи шхадоу иаҳҳәалар закәу?
Почему важно каждый день читать Библию? Что необходимо для плодотворного чтения Библии?	Избан есыҽны Абиблиа аԥхьара зхадоу? Иҟаиҵалар акәзеи ауаҩы уи ахәарҭа изаанагаларц азы?
Почему важно хорошо знать Библию?	Избан Абиблиа ҭаҳҵаалар зҳахәҭоу?
Почему для Иеговы ценен каждый проповедник благой вести?	Избан Иегова ажәабжьҳәаҩцәа зегьы рыхә зишьо?
Почему идеальных браков не существует?	Избан аҭаацәара иалоу зегьы ауадаҩрақәа изрықәшәо?
Почему Иегова создал жизнь?	Избан Иегова зегьы аԥсҭазаара зриҭаз?
Почему Иегова установил принцип главенства?	Изышьақәиргылазеи Иегова ахадара апринцип?
Почему изучающему важно найти друзей в собрании?	Избан Абиблиа зҳарҵо аизараҿы аҩызцәа иԥшаарц заҳҭаху?
Почему Иисус должен был умереть на столбе?	Избан Иисус ашьаҟаҿы дыԥсыр закәыз?
Почему Иисус подчиняется Иегове? Объясните.	Избан Иисус Иегова дзизыӡырҩуа? Иҳаилшәыркаа.
Почему Иисус просил Иегову оберегать его учеников?	Избан Иисус иҵаҩцәа рзы Иаб дызиҳәоз?
Почему мы дорожим сестрами в собрании?	Избан ҳара аизараҿы иҟоу аиҳәшьцәа рыхә заҳшьо?
Почему мы можем находить удовольствие в оскорблениях?	Избан ҳанҵәылырхуа гәахәара зҳауа?
Почему мы нуждаемся в защите Иеговы?	Избан Иегова иҟынтә ахьчара заҳҭаху?
Почему мы ценим пожилых христиан?	Избан зықәрахь инеихьоу аишьцәеи аиҳәшьцәеи рыхә заҳшьо?
Почему нам важно быть для сестер поддержкой?	Избан ҳаҳәшьцәа ргәы ашьҭыхра зҳахәҭоу?
Почему нам важно смотреть в будущее?	Избан ԥхьаҟа ҳаԥшлар зҳахәҭоу?
Почему нам нельзя быть гордыми?	Избан ҳара ҳԥагьамзар зҳахәҭоу?
Почему нам нужен большой щит веры?	Ишԥаҳацхраауеи аԥырак ду иеиԥшу ҳагәрахаҵара?
Почему нам нужна мудрость?	Избан аҟәыӷара заҳҭаху?
Почему нам нужна самодисциплина?	Избан ииашоу аҟаҵара ҳҽаҳаршьцылалар зҳахәҭоу?
Почему нам нужно быть смиренными и скромными?	Избан ахынраалара аарԥшра зҳахәҭоу?
Почему нам нужно относиться к другим с терпением?	Изҳахәҭоузеи ачҳара аарԥшра?
Почему нам нужно прощать других?	Избан ҳашьцәеи ҳаҳәшьцәеи иранаҳажьлар зҳахәҭоу?
Почему нам нужно размышлять над примерами из Библии?	Избан Абиблиаҿы зыӡбахә ану Анцәа имаҵзуҩцәа рҿырԥштәқәа ҳрызхәыцлар зҳахәҭоу?
Почему нам нужно уважать принцип главенства?	Избан ахадара апринцип ҳақәныҟәалар зҳахәҭоу?
Почему некоторые пользователи социальных сетей чувствуют одиночество и подавленность?	Избан асоциалтә каҭақәа зхы иазырхәо шьоукы рхы заҵәны изырбо?
Почему некоторым сестрам трудно найти дружеское общение?	Избан аиҳәшьцәа шьоукы аҩызцәа рыԥшаара зырцәыцәгьоу?
Почему непросто делать добро?	Избан абзиара аҟаҵара зымариам?
Почему нужно бороться с гордостью?	Избан ҳара аԥагьара ааҳарԥшлар заҳҭахым?
Почему нужно быть преданным Богу?	Избан Анцәа ҳизиашазар зҳахәҭоу?
Почему нужно читать о выкупе и размышлять над ним?	Избан аҿыхра аӡбахә аилкаареи азхәыцреи заҭаху?
Почему опасно сомневаться в том, что Иегова нас любит?	Избан Иегова бзиа ҳаибаӡом ҳәа ҳхәыцуазар, уи ашәарҭара заҵоу?
Почему Павлу сопутствовал успех?	Избан Павел ақәҿиара зимаз?
Почему Петр занимался рыбной ловлей?	Избан Пиотр аԥсыӡ зикуаз?
Почему при воскресении ум и тело человека не станут совершенными сразу же?	Избан иԥсхьоу хшыҩлеи цәеижьлеи инаӡаны рыԥсы зҭамло?
Почему проявлять нежность к братьям и сестрам порой нелегко?	Избан ҳашьцәа рахь абзиабара аарԥшра ҳцәыцәгьахар залшо?
Почему сестрам иногда нужно покрывать голову?	Избан аиҳәшьцәа зны-зынла акасы рхарҵалар зрыхәҭоу?
Почему смирение и скромность приносят нам радость?	Избан ахынраалара злоу ауаа згәырӷьо?
Почему у некоторых христиан в Коринфе были неправильные представления о воскресении?	Избан Коринф инхоз ақьырсианцәа шьоукы аԥсҭалара агәра зырымгоз?
Почему у старейшины может возникнуть желание установить в собрании какие-то правила?	Избан аизара аиҳабацәа аизараҿы аԥҟарақәа рышьақәыргылара рҭаххар залшо?
Продолжайте делать добро всем	Анаҩсгьы зегьы абзиара рзыҟашәҵала
Публичная речь: Займите сторону истинного поклонения	Иаарту ажәахә: Ииашоу амҵахырхәара аган аанышәкыл
Публичная речь: Как вы можете радовать Бога?	Иаарту ажәахә: Ишԥашәылшо Анцәа иргәырӷьара?
Публичная речь: Не насмехайтесь над Богом! Что означает это предупреждение?	Иаарту ажәахә: Анцәа шәихымыччалан! Иаанагозеи ари агәҽанҵара?
Радуемся даже в трудных обстоятельствах	Иуадаҩу аамҭақәа раангьы ҳгәырӷьоит
Радуйте сердце Иеговы!	Иегова дшәыргәырӷьала!
Развивайте умение вести разговор с людьми.	Ҟазарыла ауаа рацәажәашьа шәҵала.
Расскажите об одной из возможностей углубить свою благодарность за выкуп.	Иаҳзеиҭашәҳәа аҿыхра ахә ҳаракны ишышәшьо аазырԥшуа алшарақәа руак.
Речь о крещении	Аӡӡаахра иазку ажәахә
Родители, учите своих детей любить Иегову	Аҭаацәа, шәхәыҷқәа Иегова бзиа ибашьа дшәырҵала
Ряд докладов на тему: Будьте смелыми.	Еишьҭагылоу ажәахәқәа темас измоу: Агәымшәара аашәырԥшла.
Ряд докладов на тему: Восхваляйте Иегову всю свою жизнь!	Еишьҭагылоу ажәахәқәа темас измоу: Шәыԥсҭазаараҿы еснагь Иегова дҳарашәкла!
Ряд докладов на тему: Их любовь укрепляла других	Еишьҭагылоу ажәахәқәа темас измоу: Урҭ рыбзиабара егьырҭ арӷәӷәон
Ряд докладов на тему: Наш вклад в рост и укрепление собрания	Еишьҭагылоу ажәахәқәа темас измоу: Аизара аизҳареи арӷәӷәареи азы иҟаҳҵо
Ряд докладов на тему: Остерегайтесь сеять в плоть	Еишьҭагылоу ажәахәқәа темас измоу: Шәҽацәышәыхьчала ацәеижь азы ажәла аҟьара
РЯД ДОКЛАДОВ НА ТЕМУ: Помогайте изучающим Библию.	ЕИШЬҬАГЫЛОУ АЖӘАХӘҚӘА: Абиблиа зшәырҵо шәрыцхраала.
Ряд докладов на тему: Продолжайте сеять в дух	Еишьҭагылоу ажәахәқәа темас измоу: Анаҩсгьы адоуҳазы ажәла шәҟьала
РЯД ДОКЛАДОВ НА ТЕМУ: Пусть ваша семья будет счастливой!	ЕИШЬҬАГЫЛОУ АЖӘАХӘҚӘА: Шәҭаацәараҿы агәырӷьара шәымаз!
РЯД ДОКЛАДОВ НА ТЕМУ: Радость от подготовки учеников. Оттачивайте свои навыки:	ЕИШЬҬАГЫЛОУ АЖӘАХӘҚӘА: Аҵаҩцәа разыҟаҵара иаҳзаанаго агәырӷьара. Амаҵзураҿы ишәымоу аҟазара еиӷьышәтәла:
РЯД ДОКЛАДОВ НА ТЕМУ: Что содействует настоящей радости?	ЕИШЬҬАГЫЛОУ АЖӘАХӘҚӘА: Иҳазҭозеи агәырӷьара?
С каким настроем нужно жить каждый день? Объясните.	Иҟаҳҵалар акәзеи ҳара есыҽны? Иҳаилшәыркаа.
С каким препятствием сталкиваются юные христиане?	Иарбан уадаҩроу иқәыԥшу ақьырсианцәа зықәшәо?
С какими еще трудностями сталкивались христиане в первом веке?	Иарбан уадаҩрақәоу еиҭа актәи ашәышықәсазы инхоз ақьырсианцәа зықәшәоз?
С какими испытаниями могут встретиться служители Иеговы?	Иарбан уадаҩрақәоу Иегова имаҵзуҩцәа зықәшәо?
С какими трудностями Авраам сталкивался в семейной жизни?	Иарбан уадаҩрақәоу Авраам иҭаацәараҿы имаз?
С какими трудностями однажды столкнулся Авраам?	Дзықәшәазеи Авраам зны?
С какими трудностями сталкивался Павел?	Иарбан уадаҩрақәоу Павел дзықәшәоз?
С какой еще трудностью приходилось бороться Давиду?	Иарбан уадаҩроу Давид еиҭа имаз?
С какой целью Иоанн написал три своих письма?	Избан Иоанн х-саламшәҟәык зиҩыз?
С чем пришлось столкнуться некоторым братьям и сестрам?	Иарбан уадаҩроу шьоукы зықәшәаз?
Серия речей: Иегова дает нам радость.	Еишьҭагылоу ажәахәқәа: Иегова агәырӷьара ҳаиҭоит.
Серия речей: Радуем Иегову во всем	Еишьҭагылоу ажәахәқәа: Иегова зегь рыла дҳаргәырӷьоит
Случаи из служения	Амаҵзура аҟынтәи ахҭысқәа
Становиться другом Иеговы	Иегова дизааигәахалароуп
«Твердо стойте в вере. укрепляйтесь»	«Ишәымоу агәрахаҵара шәазықәгылаз. шәыӷәӷәаз»
«Ты будешь со мной в Раю».	«Уара Џьанаҭ усыцҟалоит».
Укреплять надежду	Шәгәыӷра шәырӷәӷәала
Учите других «любить имя Иеговы»	Идшәырҵала егьырҭ «Иегова ихьӡ бзиа абара»
Учить наизусть стихи из Библии	Абиблиатә жәеинраалақәа ҿырҳәала ишәҵала
Учиться на примерах из прошлого	Абиблиа иану аҿырԥштәқәа шәрызхәыцла
Хорошо ли вы понимаете принцип главенства в собрании?	Иарбан мчроу аизара аиҳабацәа ирымоу?
«Храни доверенное тебе»	«Угәы-уԥсы ирҭаҵәахны иумаз абри иуаҭәашьоу»
Чего нам не стоит делать?	Иҟаҳамҵалар акәзеи ҳара?
Чего ожидают люди с земной надеждой?	Изықәгәыӷлар рылшозеи адгьыл аҿы анхаразы агәыӷра змоу?
Чего с нетерпением ожидает остаток помазанников?	Иззыԥшузеи ргәы хыҭ-хыҭуа адгьыл аҿы иаанханы иҟоу доуҳала иалху ақьырсианцәа?
Чего с нетерпением ожидают другие овцы?	Ргәы хыҭ-хыҭуа иззыԥшузеи егьырҭ ауасақәа?
Чей пример служит поддержкой для одной сестры?	Лгәы шьҭызхуазеи аҭаацәара иалам иаҳәшьак?
Чем Давид отличался от Саула?	Излеиԥшымзи Саули Давиди?
Чем нам может помочь 15-я глава Первого письма коринфянам?	Хәарҭас иаҳзаанагозеи 1 Коринфаа рахь 15-тәи ахы?
Чем нам полезен призыв Павла?	Ишԥаҳацхраауеи Павел илабжьара?
Чем нам полезен пример тех, кто не сохранял спокойствия и не доверял Иегове?	Избан агәҭынчра змыхьчоз, насгьы Иегова иқәымгәыӷуаз рҿырԥштәқәа ҳрызхәыцлар зҳахәҭоу?
Чем опасна ложь отступников?	Избан аҵабырг иацәхьаҵыз рымц зшәарҭоу?
Чем похожи помазанники и другие овцы?	Излеиԥшузеи иԥшьоу адоуҳала иалху ақьырсианцәеи егьырҭ ауасақәеи?
Чему богобоязненные родители могут научиться у Иосифа и Марии?	Иднарҵар алшозеи ақьырсиантә ҭаацәа Иосифи Мариеи рҿырԥштәы?
Чему вас учат примеры Масаэ и Томоё?	Ишәнарҵозеи ҩыџьа аиҳәшьцәа рҿырԥштәы?
Чему вас учит рассказ Раджива?	Ишәнарҵозеи шәара Раџьив иҿырԥштәы?
Чему жен учит пример Иисуса?	Иднарҵозеи аҳәса Иисус иҿырԥштәы?
Чему жены могут научиться на примере Авигеи?	Иднарҵозеи аҳәса Авигеиа лҿырԥштәы?
Чему жены могут научиться на примере Марии?	Иднарҵозеи аҳәса Мариа лҿырԥштәы?
Чему можно научиться на ошибках Асы?	Иаҳдырҵар алшозеи Аса игхақәа?
Чему мужья могут научиться на примере Марии?	Иднарҵозеи ахацәа Мариа лҿырԥштәы?
Чему нас могут научить слова Карол?	Иаҳнарҵозеи Карол лҿырԥштәы?
Чему нас научила эта статья?	Еилаҳкаазеи ари астатиаҟынтә?
Чему нас учат последние слова Иисуса?	Иаҳдырҵозеи Иисус аҵыхәтәантәи иажәақәа?
Чему нас учат слова Иисуса, записанные в Иоанна 5:19, 30?	Иаҳнарҵозеи Иисус иҿырԥштәы, Иоанн 5:19, 30 иану инақәыршәаны?
Чему нас учит пример ангелов?	Иарбан ҿырԥшу амаалықьцәа иҳарҭо?
Чему пример Иеговы учит родителей и старейшин?	Иднарҵозеи аҭаацәеи аизара аиҳабацәеи Иегова иҿырԥшы?
Чему юные христиане могут научиться у Иисуса?	Иднарҵар алшозеи ахәыҷқәа Иисус иҿырԥштәы?
Что было в основе веры христиан первого века?	Шьаҭас иамази актәи ашәышықәсазы инхоз ақьырсианцәа рыгәрахаҵара?
Что в 1 Коринфянам 15:22 говорится о воскресении?	Изҵанакуада 1 Коринфаа рахь 15:22 иану ажәақәа?
Что в Библии говорится о дружбе?	Ианузеи Абиблиа аиҩызара иазкны?
Что в Иакова 5:11 говорится о глубине любви Иеговы?	Иҳаилнаркаауазеи Иаков 5:11 иану Иегова шаҟа бзиа ҳаибо иазкны?
Что в Откровении 7:11, 12 говорится о небесной семье Иеговы?	Иҳаилнаркаауазеи Иегова жәҩантәи иҭаацәара иазкны Аатра 7:11, 12 иану?
Что важно принимать во внимание главе семьи?	Ихеимыршҭуазеи аҭаацәара ахада бзиа?
Что для Иисуса было хуже самой казни?	Зегь раасҭа еицәази Иисус изы?
Что еще доверил нам Иегова?	Иҳаҭәеишьазеи уаҳа Иегова?
Что еще нам нужно делать, чтобы обрести мудрость?	Иҟаҳҵалар акәзеи иҵегьы, аҟәыӷара ҳаурц азы?
Что еще побуждает нас проповедовать?	Ҳгәазҭазҵозеи ажәабжь аҳәара?
Что значит носить нагрудник праведности?	Иаҳҳәар анбаҳалшо аиашара агәышԥыхьчага ҳшәуп ҳәа?
Что значит обуть ноги в готовность проповедовать благую весть?	Иаанагозеи ажәабжь бзиа аҳәара ҳазхиазарц азы ашьапымаҭәа ашьаҵара?
Что значит проявлять стойкость?	Иаанагозеи ахачҳара аарԥшра?
Что значит следовать по стопам Иисуса?	Иаанагозеи Иисус ишьҭа ухыланы ацара?
Что значит следовать по чьим-то стопам?	Иаанагозеи аӡә ишьҭа ухыланы ацара?
Что Иегова замечает в своих служителях?	Иидыруазеи Иегова имаҵзуҩцәа ирызкны?
Что Иисус повелел ангелам?	Иарбан дҵоу Иисус амаалықьцәа ириҭаз?
Что Иоанн говорил о любви?	Дызлацәажәози Иоанн ииҩуаз ашәҟәқәа рҿы?
Что мешает некоторым христианам принимать помощь от других?	Избан ацхыраара адкылара ҳцәыцәгьахар залшо?
Что могло помешать дружбе Ионафана с Давидом?	Иаԥырхагахар алшози Ионафани Давиди реиҩызара?
Что может влиять на то, как мужья относятся к своей жене и детям?	Ишԥарзыҟоу ахацәа шьоукы рыҳәсеи рхәыҷқәеи, насгьы избан?
Что может помешать прислушаться к предостережению друга?	Иԥырхагахар алшозеи ауаҩы иҩыза иҟынтә иоуа алабжьара бзиа адкылара?
Что можно делать, чтобы более умело проповедовать и обучать других?	Иҳацхраар алшозеи ажәабжьҳәаратә, насгьы арҵаратә ус аҿы ҳҟазара аиӷьтәра?
Что можно сказать о наших юных братьях?	Иаҳҳәар ҳалшозеи иқәыԥшу аишьцәа ирызкны?
Что мы настроены делать?	Ҳзызхиазар ҳахәҭоузеи ҳара?
Что мы обсудим в следующей статье?	Еилҳаргозеи анаҩстәи астатиаҿы?
Что мы обсудим в этой статье?	Еилҳаргозеи ари астатиаҿы абиблиатә ҵара шымҩаԥгалатәу иазкны?
Что мы пожнем, если не ослабеем	Ҳамчыдамхар, иҭаҳгало аҽаҩра
Что мы понимаем под словом «истина»?	Иаанагозеи ҳара ҳзы ажәа «аҵабырг»?
Что мы рассмотрим в этой статье?	Еилҳаргозеи ари астатиаҿы?
Что мы узнаём о принципе главенства из 1 Коринфянам 11:3?	Еилаҳкаауазеи ахадара апринцип иазкны 1 Коринфаа рахь 11:3 аҟынтә?
Что нам нужно делать? Что мы обсудим в следующей статье?	Ҳзызхәыцлар ҳахәҭоузеи ҳара? Еилҳаргозеи анаҩстәи астатиаҿы?
Что нам обещает Иегова, согласно Исаии 41:10, 13?	Ҳазқәиргәыӷуазеи Иегова, Исаиа 41:10, 13 иану инақәыршәаны?
Что нужно включать в свои молитвы?	Иаҳҳәалар ҳалшозеи иҵегьы Анцәа ҳаниҳәо?
Что нужно и дальше делать христианам после крещения?	Иҟарҵалар рыхәҭоузеи зыҽӡаазххьоу ақьырсианцәа?
Что нужно молитвенно обдумать главе семьи?	Ибзианы дзызхәыцыр акәзеи аҭаацәара ахада?
Что общего у глав семей и старейшин?	Еицырзеиԥшузеи аҭаацәара ахадацәеи аизара аиҳабацәеи?
Что открыто признавал апостол Павел?	Ииҳәози Павел имӡакәа?
Что помогало Иосифу бороться с унынием?	Ицхраазеи Иосиф агәҭынчра ахьчара?
Что помогло Ае и Хектору справиться со своими испытаниями?	Ирыцхраазеи Аиеи Хектори ирымаз ауадаҩрақәа риааира?
Что помогло апостолу Павлу не испытывать чрезмерного чувства вины?	Ицхраазеи Павел мыцхәы ихы ахара адымҵара?
Что помогло Исангу справиться с потрясением после несчастного случая?	Ицхраазеи Исанг агәкаҳара аиааира?
Что помогло одной сестре не тосковать по прошлому?	Илыцхраазеи иаҳәшьак ииасхьаз мыцхәы агәхьаамгара?
Что поможет вам пройти обучение в Школе благовестников Царства?	Ишәыцхраар алшозеи Аҳра ажәабжьҳәаҩцәа рышкол аҿы аҵара ахысра?
Что поможет вам стать умелыми проповедниками и учителями благой вести?	Иарбан ҟазшьақәоу ишәыцхраауа Иисус иааԥхьара адкылара?
Что поможет изучающему полюбить библейские истины?	Ицхраар алшозеи Абиблиа зшәырҵо абиблиатә ҵабырг бзиа абара?
Что поможет изучающему расти духовно?	Ицхраауазеи Абиблиа зҳарҵо ауаҩы доуҳала аизҳара?
Что поможет нам более умело пользоваться Библией?	Иҳацхраауазеи Абиблиа еиҳа еиӷьны ахархәара?
Что поможет нам воспитать самодисциплину?	Иҳацхраар алшозеи иаҳцәыцәгьоу аусқәа рынагӡара?
Что поможет нам не терять из виду важность дела проповеди?	Ҳгәазҭазҵозеи ҳхы ҳамеигӡакәа ажәабжь аҳәара?
Что поможет нам оживить рассказы из Евангелий?	Иҳацхраауазеи Аевангелиеқәа рҿы ҳзыԥхьо аԥсы ахаҵара?
Что поможет нам победить уныние?	Иҳацхраауазеи агәкаҳара аиааира?
Что поможет нам развить нежные чувства к братьям и сестрам?	Иҳацхраауазеи ҳашьцәеи ҳаҳәшьцәеи рахь абзиабара аизырҳара?
Что поможет нам сопротивляться искушению?	Иҳацхраауазеи ҳхызхыр алшо аҿагылара?
Что признавал апостол Павел? Что мы обсудим в этой статье?	Ииҳәазеи апостол Павел? Еилҳаргозеи ари астатиаҿы?
Что приносит сестрам радость?	Ргәы шьҭызхуазеи аиҳәшьцәа?
Что свидетельствует о порядке и мире в организации Иеговы?	Иаҳзырбозеи Иегова иорганизациаҿы акзаареи аҭынчреи шыҟоу?
Что сказал Давид о смирении Иеговы?	Ииҳәазеи Давид Иегова ихынраалара иазкны?
Что случилось в жизни Ноемини и Руфи?	Изықәшәазеи Ноемини Руфи?
Что, согласно Иоанна 19:26, 27, Иисус сказал Марии и Иоанну и почему?	Иреиҳәазеи Иисус Мариеи Иоанни, Иоанн 19:26, 27 иану инақәыршәаны, насгьы избан?
Что такое закон Христа?	Изакәызеи Христос изакәанԥҟара?
Что такое любовь к Богу?	Изакәызеи Анцәа иахь абзиабара?
Юноши и девушки, пусть Иегова будет вашим лучшим другом	Арԥарцәеи аҭыԥҳацәеи, Иегова шәҩыза бзиа иакәзааит
Юные братья, как вам завоевать доверие собрания?	Иқәыԥшу аишьцәа, иҟашәҵар шәылшозеи шәара аишьцәеи аиҳәшьцәеи шәыгәра ргаларц азы?
А вы читали эту книгу?	Шәаԥхьахьоума шәара ари ашәҟәы?
А как Иегова может задействовать тебя?	Ишԥаилшо Иегова ихы уаирхәар?
А как ты мог бы проявлять любовь на конгрессе?	Ишԥаулшо аконгресс аҿы абзиабара аарԥшра?
А что мешает тебе? Эта причина сама собой не исчезнет, тебе придется потрудиться. Но ты не пожалеешь!	Иуԥырхагоузеи уара? Уи амзыз ахала ицаӡом, уи азы аџьабаа батәуп. Аха уи ахаан уахьхәӡом!
Абзац 14. «Джони и Гидеон: были врагами, стали братьями»	Абзац 14. «Џьонии Гедеони: еиӷацәан, аха еишьцәахеит»
Абзац 5. «Для Бога каждая жизнь драгоценна»	Абзац 5. «Анцәа изы дарбанзаалак ауаҩы иԥсҭазаара ахә ҳаракуп»
Активно работай в классе.	Аурокқәа ибзианы ухы рылархәла.
акции и ценные бумаги,	акциақәеи зыхә ҳараку ақьаадқәеи,
банковские вклады,	абанктә алаҵарақәа,
Берегись гордости и самоуверенности!	Аԥагьареи ахақәгәыӷреи шәҽырцәышәыхьчала!
Билл Уолден с готовностью шел на жертвы, и Иегова его вознаградил	Уолден Билл ахамеигӡара аарԥшра дазхиан, убри аҟынтә Иегова дизылԥхеит
Благодаря Богу и Христу нас ждет свобода!	Анцәеи Христоси рыбзоурала ахақәиҭра ҳауеит!
Благодаря чему зубы морских блюдечек оказались прочнее паучьего шелка?	Избан асаан гәаҩа хәыҷ еиԥшу амшын иҭоу ашамҭа ахаԥыцқәа абызкаҭаҳа аасҭа изыӷәӷәоу?
Благодаря чему такое будущее станет возможным?	Изыбзоурахозеи уи аҩыза аԥсҭазаара?
«Бог любит чистый народ»	«Анцәа бзиа ибоит ицқьоу ажәлар»
«Богу „известны тайны сердца“»	«Анцәа „ҳгәы маӡас иҭоу зегь“ идыруеит»
«БУДЕМ ЖИТЬ МИРНО»	«ҬЫНЧ ҲАИЦЫНХАЛАП»
Будет ли Земля уничтожена?	Иқәгахома Адгьыл?
Будь уверен: ты справишься с любым жизненным штормом, ведь после бури обязательно выглянет солнце	Агәра ганы уҟаз: аԥсҭазааратә цәқәырԥақәа рыхгара улшоит, избанзар афырҭын ашьҭахь хымԥада амра цәырҵуеит
Будьте сильными!	Шәҽырӷәӷәаны шәыҟаз!
Будьте смелыми!	Агәымшәара аашәырԥшла!
В 2021 году Вечеря воспоминания пройдет в субботу, поэтому встреча собрания в выходные дни проводиться не будет. По этой причине на следующую неделю статья для изучения не запланирована.	шықәсазы Агәаларшәара ахәылԥаз асабшамш иақәшәоит аҟынтә, аԥсшьара мшқәа рзы аизара мҩаԥысӡом. Убри аҟынтә анаҩстәи амчыбжь азы аҵаразы астатиа ҟалаӡом.
В Библии нет прямых указаний в отношении кремации. В ней не уточняется, следует ли хоронить тело умершего или же кремировать.	Абиблиаҿы акремациа иазкны иаартны акгьы анӡам. Уа ишьақәырӷәӷәаӡам иԥсыз ауаҩы дыжтәу, мамзаргьы дбылтәу.
В день нашей свадьбы. 1951 год	шықәса. Ҳанеибагаз амш аҽны
В 15-й главе Первого письма коринфянам говорится о воскресении. Почему это учение для нас так важно и почему мы можем быть уверены, что Иисус воскрес? Давайте обсудим эти и другие вопросы, связанные с воскресением.	Актәи Коринфаа рахь 15-тәи ахы аԥсҭалара иазкуп. Избан ари аҵабырг ҳара ҳзы изхадоу, насгьы избан Иисус иԥсы шҭалаз агәра ганы ҳаҟазар зҳалшо? Ари астатиаҿы арҭ, насгьы аԥсҭалара иазку ихадоу егьырҭ азҵаарақәа рҭак ҳауеит.
В каких ситуациях сестрам может понадобиться наша защита?	Ианбаҭаххар алшо ҳаҳәшьцәа рыхьчара?
В каких ситуациях тебе может потребоваться мужество, чтобы объяснить свои убеждения представителю власти?	Иарбан ҭагылазаашьақәоу агәымшәара уҭаххар ахьалшо, амчра змоу ауаҩы угәрахаҵара иеилыркааразы?
В каких ситуациях тебе может пригодиться приложение JW Language?	Иуҭаххар анбалшо апрограмма JW Language?
В каком случае Евангелия по-настоящему нам помогут?	Иҟаҵалатәузеи Аевангелиеқәа ирну хәарҭа ҳзааргаларц азы?
В каком смысле мы можем находить удовольствие в оскорблениях?	Избан ҳанҵәылырхуа гәахәара зҳауа?
«В каком состоянии находятся умершие?»	«Иарбан ҭагылазаашьоу ирымоу иԥсхьоу?»
В КАКОМ ТЕЛЕ ОНИ ВОСКРЕСНУТ?	ИАРБАН ЦӘЕИЖЬУ ИРОУА?
В ночь перед своей смертью Иисус вместе с верными апостолами пел песни хвалы Иегове.	Иисус иԥсра уахык шагыз изиашоу иапостолцәеи иареи Иегова дзырҽхәо ашәақәа рҳәон.
В первый день на новой работе Майкла Кензела спросили: «Как думаешь, виноват ли Бог во всех страданиях и несчастьях?» Это был поворотный момент в его жизни.	Маикл Кензел аусура ҿыц даналага аҽныҵәҟьа иазҵааит: «Угәы ишԥаанаго, агәаҟрақәеи арыцҳарақәеи зегь Анцәа ихароума?» Уи иԥсҭазаара зегь аԥсахит.
В период холокоста в Германии и на оккупированных нацистами территориях проживало приблизительно 35 000 Свидетелей Иеговы. Около 1 500 из них погибло. Причины их смерти установлены не во всех случаях. Эта тема до сих пор изучается, поэтому цифры и другие факты могут обновляться.	Германиа ахолокост аан анацистцәа ирымпыҵархалаз аҭыԥқәа рҿы иқәынхон 35 000-ҩык раҟара Иегова ишаҳаҭцәа. Урҭ рҟынтә 1 500-ҩык раҟара ҭахеит. Шьоукы рыԥсышьа амзызқәа еилкааӡам. Ари атема иахьа уажәраанӡагьы иҭырҵаауеит, убри аҟынтә ахыԥхьаӡареи егьырҭ афактқәеи рҽырыԥсахлар алшоит.
В следующий раз. Как Бог отвечает на наши молитвы?	Анаҩстәи аан. Ишԥаҟаиҵо Анцәа ҳаҳәарақәа рҭак?
В следующий раз. Как выразить благодарность за искупительную жертву Иисуса?	Анаҩстәи аан. Ишԥааҳарԥшуеи аџьшьара Иисус иҿыхратә ԥсхҭынҵаразы?
В следующий раз. Когда Царство Бога начнет править землей?	Анаҩстәи аан. Ианбалаго Анцәа Иаҳра адгьыл аҿы напхгара аура?
В следующий раз. О чем можно молиться?	Анаҩстәи аан. Ҳзызиҳәалар ҳалшозеи Анцәа?
В следующий раз. Почему Иисус должен был умереть?	Анаҩстәи аан. Избан Христос дыԥсыр закәыз?
В следующий раз. Что происходит после смерти?	Анаҩстәи аан. Иҟалозеи ауаҩы данԥслак ашьҭахь?
«В ТВОИ РУКИ ВВЕРЯЮ МОЙ ДУХ»	«СЫԤСЫ УНАПЫ ИАНЫСҴОИТ»
В чем Зимри и другие убеждали Иамина?	Зыгәра идыргози Иамин Зимрии егьырҭ ахацәеи?
В чем польза физических упражнений?	Иамоузеи хәарҭас абаҩрҵәыра?
В чем проявляется смирение главы семьи?	Иааирԥшлар шԥаилшо аҭаацәара ахада ахынраалара шилоу?
В чем разница между дружелюбием и дружбой?	Излеиԥшымзеи ауаҩы қьиарала изыҟазаареи иҩызахареи?
В чем сходство между супружеской изменой и идолопоклонством?	Еицырзеиԥшузеи ахатә ҩыза иԥсахреи амцмҵахырхәареи?
«Вера в Бога»	«Анцәа дшыҟоу агәра агара»
Видел ли кто-нибудь Бога?	Дибахьоума аӡәыр Анцәа?
Влияние на беременность. У курящих матерей дети чаще рождаются недоношенными, с низким весом или с такими пороками развития, как расщелина губы. Кроме того, эти дети подвержены сердечно-сосудистым заболеваниям и могут умереть от синдрома внезапной детской смерти.	Ахшараиура иазыԥшу ишырныруа. Аҭаҭын иахо ахшараиура иазыԥшу аҳәса лассы-лассы ироураны иҟоу ахәыҷқәа раамҭа ааиаанӡа ииуеит, рыкапан маҷуп, насгьы аграқәа рымоуп. Уи адагьы урҭ ахәыҷқәа агәы ачымазарақәа роуеит, насгьы иаалырҟьаны иԥсыр алшоит.
внять предостережению друга?	ариашара адкылара?
«ВО ВСЕМ СОХРАНЯЮ СТОЙКОСТЬ»	«ИАРБАН ГӘАҞРАЗААЛАКЬ АХГАРА САЗХИОУП»
Во что верят Свидетели Иеговы?	Зыгәра ргозеи Иегова ишаҳаҭцәа?
Вопрос. Как справиться с болью утраты?	Азҵаара. Ишԥаҳалшо иаҳзааигәоу ауаҩы иԥсра ахьаа ахгара?
Вопрос. Кем был Иисус Христос?	Азҵаара. Дызусҭадаз Иисус Христос?
Вопрос. О чем можно молиться?	Азҵаара. Ҳзызиҳәалар ҳалшозеи Анцәа?
Вопрос. Почему Иисус должен был умереть?	Азҵаара. Избан Христос дыԥсыр закәыз?
Вопрос. Слушает ли Бог молитвы?	Азҵаара. Дырзыӡырҩуама Анцәа ҳаҳәарақәа?
Вопрос. Что происходит после смерти?	Азҵаара. Иҟалозеи ауаҩы данԥслак ашьҭахь?
Вопрос. Что такое Царство Бога?	Азҵаара. Изакәызеи Анцәа Иаҳра?
Вот некоторые причины:	Абар мзызқәак:
Вот что тебе нужно:	Абар уара иуҭаху:
«Всегда готовы сохранять нейтралитет»	«Анеитралитет ахьчара еснагь иазхиоуп»
Всегда радуйтесь!	Еснагь шәгәырӷьала!
Вы важны для собрания Иеговы!	Аизараҿы инашәыгӡо аус Иегова изы ахә ҳаракуп!
Вывод. Не позволяй сверстникам заставить тебя опустить планку своих нравственных принципов.	Алкаа. Уқәлацәа узықәныҟәо апринципқәа реилагара удырцалартә алумыршан.
Газетное объявление о речи «Миллионы теперь живущих никогда не умрут»	Ажәахә «Миллионы теперь живущих никогда не умрут» иазку аӡыргара агазеҭ аҿы
Где они погибли?	Иабаҭахеи дара?
Глава 19. Берегите дружбу с Иеговой	Ахы 19. Иеговеи шәареи шәеиҩызара ахә шәшьала
Глава 14. Будь честным во всём	Ахы 14. Иҟауҵозаалак ламысцқьарала ухы мҩаԥгала
Глава 6. Как выбирать развлечения	Ахы 6. Ихәарҭоу агәырҿыхагақәа шалхтәу
Глава 15. Как правильно поклоняться Богу?	Ахы 15. Ишәыцхраар алшозеи ииашоу адинхаҵара аԥшаара?
Глава 12. Как стать другом Бога?	Ахы 12. Ишԥашәылшо Анцәеи шәареи шәеиҩызцәахар?
Глава 1. Кто такой Бог?	Ахы 1. Дызусҭада Анцәа?
Глава 4. Кто такой Иисус Христос?	Ахы 4. Дызусҭада Иисус Христос?
Глава 1. Любовь Бога длится вечно	Ахы 1. Иаазырԥшуазеи Анцәа иахь абзиабара
Глава 17. Оставайся в любви Бога	Ахы 17. Уҽырӷәӷәала иԥшьоу угәрахаҵара шьаҭас иҟаҵаны
Глава 11. После свадьбы	Ахы 11. Аҭаацәалазаара зегьы пату рзақәзааит
Глава 11. Почему в мире так много зла?	Ахы 11. Избан адунеи гәаҟрала изҭәу?
Глава 4. Почему нужно уважать власть?	Ахы 4. Избан амчра пату зақәҵалатәу?
Глава 10. Правда об ангелах и демонах	Ахы 10. Амаалықьцәеи адемонцәеи ирызку аиаша
Глава 16. Противостой Дьяволу	Ахы 16. Шәырҿагыл Аџьныши игьангьашу иусқәеи
Глава 15. Пусть работа приносит тебе радость	Ахы 15. Уџьа алҵшәа бзиақәа агәахәара узааргалааит
Глава 9. «Убегайте от блуда»	Ахы 9. «Акалҭбааԥсра шәхы ацәышәыхьча»
Глава 13. Цените дар жизни	Ахы 13. Ҳамҭас ишәыҭоу аԥсҭазаара ахә ҳаракны ишәшьала
Глава 3. Что Бог хочет сделать для людей?	Ахы 3. Игәы иҭеикзеи Анцәа ауаа рзы?
Глава 9. Что будет с этим миром?	Ахы 9. Иааигәоума адунеи аҵыхәтәа?
Глава 14. Что нужно для семейного счастья	Ахы 14. Шәҭаацәара насыԥ амазар алшоит
Глава 6. Что происходит с человеком после смерти?	Ахы 6. Иабаҟоу иԥсхьоу ауаа?
Глава 8. Что такое Царство Бога?	Ахы 8. Изакәызеи Анцәа Иаҳра?
«Глубокое личное изучение помогает твердо держаться Слова Бога»	«Иҵаулоу хаҭалатәи аҭҵаара Анцәа Иажәа ақәныҟәара иҳацхраауеит»
Говорится ли в Библии об использовании марихуаны и других наркотиков ради удовольствия?	Ианума Абиблиаҿы амарихуанеи егьырҭ анаркотик маҭәашьарқәеи агәахәаразы рыдкылара атәы?
Говорить с Иеговой, каждый день молясь ему	Есыҽны Анцәа диҳәалароуп, убас ала иара Иегова диацәажәалоит
Готов ли ты к празднованию Вечери?	Уазхиоума Ахәылԥаз азгәаҭара?
Готовы ли вы и дальше исправляться?	Шәазхиоума шәара анаҩсгьы аҽыԥсахра?
Готовы ли вы стать «ловцами людей»?	Шәазхиоума шәара «уаакцәаҩны» аҟалара?
«Для Бога каждая жизнь драгоценна»	«Анцәа изы дарбанзаалак ауаҩы иԥсҭазаара ахә ҳаракуп»
Для Иеговы жизнь человека драгоценна. Как нам развить такое же отношение к дару жизни?	Иегова изы ауаҩы иԥсҭазаара ахә ҳаракуп. Ишԥаҳалшо ҳаргьы аԥсҭазаарахь убри аҩыза ахәаԥшышьа аизырҳара?
«Для чего Бог создал землю?»	«Изишазеи Анцәа адгьыл?»
Дружба с Иеговой никогда не закончится!	Иеговеи уареи шәеиҩызара ахаангьы инҵәаӡом!
Если вы хотите сделать пожертвование, зайдите на donate.jw.org.	Хатәгәаԥхарала аҭара ҟашәҵар шәҭахызар, асаит donate.jw.org шәҭал.
Если вы хотите сделать пожертвование, посетите сайт www.jw.org/ru.	Хатәгәаԥхарала аҭара ҟашәҵар шәҭахызар, асаит www.jw.org/ab шәҭал.
Если изучающий не растет духовно, откровенно, но по-доброму поговорить с ним	Деизымҳауазар, ирҟәымшәышәны, аха иаартны шәиацәажәа
Если у вас остались вопросы о верованиях Свидетелей Иеговы, больше информации вы можете получить на нашем сайте, в одном из наших филиалов, на встрече в ближайшем к вам Зале Царства и в личной беседе с кем-то из Свидетелей Иеговы, живущих в вашей местности.	Иегова ишаҳаҭцәа рҵарақәа ирызкны азҵаарақәа шәзынхазар, еиҳаны еилышәкаар шәылшоит ҳсаит аҿы, ҳфилиалқәа руак аҿы, шәааигәара иҟоу Аҳратә Зал аҿы, мамзаргьы шәара шәҭыԥ аҿы инхо Иегова ишаҳаҭцәа руаӡәк шәиацәажәар шәылшоит.
Если человеку интересно. Почему Иисус должен был умереть?	Ауаҩы аинтерес имазар. Избан Христос дыԥсыр закәыз?
Есть ли у Бога имя?	Имоума Анцәа ахьӡ?
За что братья хвалили Сергея?	Избан аишьцәа Сергеи дыздырҽхәоз?
За что нас могут хвалить?	Ҳаздырҽхәар алшозеи ҳара?
За что ты любишь Иегову?	Бзиа дзубозеи Иегова?
Заблуждение. В библейские времена сжигали тела только неугодных Богу людей.	Ииашам агәаанагара. Абиблиатә аамҭақәа раан Анцәа изымӡырҩуаз ауаа ракәын ирбылуаз.
Зачем нам нужно следовать по стопам Иисуса?	Избан Иисус ишьҭа ҳхыланы ҳцалар закәу?
Знаете ли вы?	Ижәдыруама шәара?
«Знакомство с Евангелием от Матфея»	«Матфеи иҟынтә Аевангелие ахҳәаа»
«Иегова Бог поможет тебе»	«Анцәа Иегова уара дуцхраауеит»
«Иегова всегда помнил обо мне»	«Иегова сихамышҭӡеит»
«Иегова даст».	«Иегова исиҭоит».
Иегова дорожит вами!	Иегова шәыхә ҳаракны ишьоит!
Иегова с радостью проявляет к нам милосердие.	Иегова ҳара ҳахь агәшаҭара аарԥшра игәаԥхоит.
«Иегова там».	«Иегова уа дыҟоуп».
Из чего будет видно, что преданность Иегове для нас важнее привязанности к родным?	Излоубарҭахозеи Иегова иахь азиашара ҳара ҳзы еиҳа ишхадоу, ҳҭынхацәа рахь иҳамоу ацәаныррақәа раасҭа?
изменить свой образ мышления и поведение?	ҳхәыцшьеи ҳхымҩаԥгашьеи рыԥсахра?
Израильский лагерь: уроки для нас	Израильтәи алагерь: ҳара ҳзы аурокқәа
Имена изменены.	Хьыӡқәак ԥсахуп.
Имя изменено.	Ахьӡ ԥсахуп.
Интересуйся успехами этих братьев и заверяй их в том, что у них все получится.	Урҭ аишьцәа урыдҵаалала, насгьы ирыду шырзынагӡо агәра дыргала.
Исповедование своей веры. Несмотря на то что власти запретили Свидетелям Иеговы исповедовать их веру, те не прекращали.	Рыгәрахаҵара атәы аҳәара. Иегова ишаҳаҭцәа рыгәрахаҵара атәы аҳәара мап шацәкызгьы, дара аҟәыҵӡомызт.
исполняя почетные обязанности в организации Иеговы?	Иегова иорганизациаҿы аҭакԥхықәрақәа анынашәыгӡо?
История современных служителей Иеговы ясно показывает, что он по-прежнему ведет и защищает свой народ. Именно этой теме посвящена выставка «Народ во имя Иеговы» во всемирном главном управлении.	Ҳаамҭазы инхо Иегова имаҵзуҩцәа рҭоурых еилыкка иаҳнарбоит иара иахьагьы ижәлар дышрыцу, насгьы дышрыцхраауа. Абри атема ауп изызку адунеизегьтәи ихадоу аусбарҭаҿы иҟоу «Иегова ихьӡ зху ажәлар» захьӡу ацәыргақәҵа.
Кажется, ваш ребенок позабыл про школу, потерял интерес к учебе и делает уроки спустя рукава. В итоге его оценки и поведение оставляют желать лучшего. Как помочь ребенку повысить успеваемость?	Иҟалап ахәыҷы ашкол хьаас имамзар, аҵарахьы аинтерес ицәыӡзар, насгьы аурокқәа ишабалак иҟаиҵозар. Убри иахҟьаны ихәшьарақәеи ихымҩаԥгашьеи ҽеимзар ауеит. Ишԥашәылшо шәхәыҷы ихәшьарақәа реиӷьтәра шәицхраар?
Как 1 Петра 5:5 помогает нам быть смиренными и скромными?	Ишԥаҳацхраауеи 1 Пиотр 5:5 иану ахынраалареи ахӡырымгареи аарԥшра?
Как братья и сестры проявили любовь к делегатам международных конгрессов 2019 года?	Ишԥаадырԥши аишьцәеи аиҳәшьцәеи абзиабара 2019 шықәсазтәи жәларбжьаратәи аконгресс иаҭааз рахь?
КАК БУДЕТ ПРОХОДИТЬ ВОСКРЕСЕНИЕ?	ИШԤАҞАЛО АԤСҬАЛАРА?
КАК БЫ ВЫ ОТВЕТИЛИ?	ШӘГӘЫ ИШԤААНАГО?
Как в древнем Израиле все было хорошо организовано, так и сегодня в народе Бога царит порядок. При этом у Иеговы к каждому индивидуальный подход, и он ценит усилия каждого из нас.	Ажәытәан израильаа рыбжьара аиҿкаара шыҟаз еиԥш, иахьагьы Анцәа ижәлар рыбжьара аиҿкаара ыҟоуп. Убри аамҭазгьы Иегова хаҭала зегьы иҟаҳҵо ибоит, насгьы уи ахә ишьоит.
«Как воскресают мертвые?»	«Аԥсцәа рыԥсы злаҭалоузеи?»
Как воспитать самодисциплину?	аиҿкаара аҽаршьцылара?
Как выразить свою любовь к братьям и сестрам?	Иааҳарԥшлар шԥаҳалшо аишьцәеи аиҳәшьцәеи бзиа ишаҳбо?
Как древняя надпись подтверждает достоверность Библии?	Ишԥашьақәнарӷәӷәо ажәытә напынҵамҭа Абиблиа агәра агара ишаԥсоу?
Как другие в собрании могут помочь тебе служить Иегове?	Иуцхраар шԥарылшо аизараҿы аишьцәеи аиҳәшьцәеи Иегова имаҵ аура?
Как еще Иегова нас защищает?	Ҳашԥеихьчо Иегова иҵегьы?
Как еще ты мог бы подготовиться?	Ишԥаулшо иҵегьы аҽазыҟаҵара?
Как Иегова в этих непростых обстоятельствах помог брату Михайлову дать свидетельство другим заключенным?	Дышԥаицхрааи Иегова ҳашьа иҭагылазаашьақәа шымариамызгьы ицҭакыз шаҳаҭра рыҭара?
Как Иегова вас защищает?	Ҳашԥеихьчо ҳара Иегова?
Как Иегова вознаградил их?	Дышԥарзылԥхеи урҭ Иегова?
Как Иегова помог брату перенести эти испытания?	Дышԥаицхрааи Иегова Дмитри аԥышәарақәа рыхгара?
Как испытывалось послушание возвещателей, когда им сказали перейти в другое собрание?	Ишԥаԥышәаз ажәабжьҳәаҩцәа иаадырԥшуаз аӡырҩра, даҽа еизарак ахь ишиастәу анрарҳәа?
Как крохотные колибри проявляют мужество?	Ишԥаадырԥшуеи агәымшәара аколибри хәыҷқәа?
Как лошадей готовят к бою?	Ишԥазыҟарҵо аҽқәа аибашьра?
Как львицы защищают своих детенышей?	Ишԥарыхьчо алымқәа-анацәа рхәыҷқәа?
Как могут помочь добровольцы?	Ацхыраара ҟарҵар шԥарылшо хатәгәаԥхарала амаҵ аура зҭаху?
Как можно «увидеть» Бога сейчас	Уажәы Анцәа «ибара» шҳалшо
Как можно уделять внимание сестрам?	Хәарҭас ирзаанагозеи ҳаҳәшьцәа ҳаамҭа ахьырзаҳкуа?
Как можно укрепить уверенность в истинности своих убеждений?	Ишԥашәылшо Абиблиа иану шҵабыргу агәра жәгар?
Как мы можем брать пример с Авраама?	Ишԥаҳалшо Авраам иҿыԥшра?
Как мы можем во всем поддерживать верного и благоразумного раба?	Ишԥаҳалшо зегь рыла игәрагоу иҟәышу атәы ицхраара?
Как мы можем проявлять нежность и теплоту?	Иааҳарԥшлар шԥаҳалшо абзиабара?
Как надежда на воскресение помогает нам, когда мы сталкиваемся с трудностями?	Ишԥаҳацхраауеи аԥсҭалара агәра ахьаҳго, ҳаԥсҭазаара ашәарҭара ианҭагыло?
Как нам нужно относиться к сестрам?	Ҳарзыҟазар шԥаҳахәҭоу аиҳәшьцәа?
Как нам помогают Иисус и ангелы?	Ишԥаҳацхраауеи Иисуси амаалықьцәеи?
Как Нита с помощью вопросов побудила Джейд размышлять?	Ишԥалылшеи Нита азҵаарақәа рыла Џьеид ахәыцра лгәазҭаҵара?
Как Нита с помощью вопросов проявила к Джейд личное внимание?	Ишԥаалырԥши Нита Џьеид лахь аинтерес?
как нужно относиться к окружающим.	егьырҭ ҳарзыҟазар шҳахәҭоу.
Как нужно относиться к помазанникам?	Ҳарзыҟазар шԥаҳахәҭоу доуҳала иалху ақьырсианцәа?
Как нужно поступить, если высказывания о других становятся саркастичными и недобрыми?	Ҳхы мҩаԥаҳгар шԥаҳахәҭоу, егьырҭ рыхцәажәара аҵәы алхреи ақьиара знымԥшуа ажәақәеи рахь ииасуазар?
Как они погибли?	Ишԥаҭахеи дара?
Как перестать видеть все в мрачном свете?	Ишԥасылшо иҽеим ахәыцра аҽацәыхьчара?
Как побудить изучающего посещать встречи собрания?	Игәазҭаҳҵар шԥаҳалшо Абиблиа зҳарҵо аизарақәа рахь аныҟәара?
Как повысить успеваемость?	Ишԥасылшо ашкол аҿы сеихьӡарақәа еиӷьыстәыр?
Как поддерживать изучающих Библию, которые приходят на встречи собрания?	Абиблиа зҵо, насгьы аизарақәа рахь иныҟәо ргәы шьҭаҳхлар?
Как полюбить занятия спортом?	Ишԥасылшо абаҩрҵәыра аҟаҵара сҽасыршьцылар?
Как помогать друг другу оставаться в истине?	Ҳаицхыраалар шԥаҳалшо аҵабырг мҩала ацара?
Как помочь изучающим Библию полюбить Иегову?	Ишԥаҳалшо Абиблиа зҳарҵо Иегова иахь абзиабара аизырҳара ҳрыцхраар?
Как помочь изучающим Библию соблюдать повеления Иисуса?	Абиблиа зҳарҵо Христос иԥҟарақәа рынагӡара ҳрыцхраар?
Как помочь изучающим найти друзей в собрании?	Ҳрыцхраар шԥаҳалшо Абиблиа зҳарҵо аизараҿы аҩызцәа рыԥшаара?
Как помочь неактивным братьям и сестрам возобновить служение?	ажәабжьҳәара иаҟәыҵыз ҳашьцәеи ҳаҳәшьцәеи ҩаԥхьа уи аҽалархәра ҳрыцхраар?
Как поступок одного человека может многое изменить?	Иалшома аӡәы заҵәык ихымҩаԥгашьа аҭагылазаашьа аԥсахыр?
Как пример этих сестер воодушевил других?	Ргәы зызҭанаҵазеи арҭ аиҳәшьцәа рҿырԥштәы егьырҭ?
Как приучить себя заниматься спортом?	Ишԥасылшо абаҩрҵәыра аҟаҵара сҽасыршьцылар?
Как проповедническое служение сближает тебя с Иеговой?	Ишԥауцхраауеи ажәабжьҳәаратә ус Иегова изааигәахара?
Как противостоять соблазнам?	Ишԥасылшо ахыхра аҿагылара?
«Как проходит изучение Библии?»	«Ишԥамҩаԥысуеи абиблиатә ҵара?»
Как связаны мужество и послушание?	Ишԥеидҳәалоу азыӡырҩреи агәымшәареи?
Как слоны защищают других слонов?	Ишԥарыхьчо асланқәа егьырҭ асланқәа?
Как собрание может поддержать христиан, чей родственник перестал быть Свидетелем Иеговы?	Ишԥарылшо аизара, уаҳа Иегова ишаҳаҭым аҭынха дызмоу ақьырсианцәа рыцхраара?
Как сообщение из книги Исход убеждает тебя в том, что Иегова исполнит все свои обещания?	Агәра шԥаунарго ашәҟәы Ақәҵымҭа иану аацҳара, Иегова иқәыргәыӷрақәа зегь шынаигӡо?
Как старейшины могут помогать изучающим Библию расти духовно?	аизара аиҳабыс амаҵ ҳуазар?
Как ты можешь внести свою лепту в этот проект, даже если обстоятельства не позволяют тебе участвовать в строительстве?	Ацхыраара ауҭар шԥаулшо ари апроект, уҭагылазаашьақәа аргылара аҽалархәразы алшарақәа урымҭозаргьы?
Как ты можешь научиться мужеству на примере этих животных?	Ишԥаулшо уара агәымшәара аарԥшра арҭ аԥстәқәа урҿыԥшны?
Как ты можешь подготовиться к посвящению и крещению?	Уҽазыҟауҵар шԥаулшо аҽазкреи аҽӡаахреи?
Как ты можешь подражать назореям?	Ишԥаулшо аназореицәа рҿыԥшра?
Как уважение к дару жизни убережет нас от вины в пролитии крови?	Ҳашԥахьчо аԥсҭазаарахь апатуқәҵара ашьакаҭәара ахара аҟынтә?
Как углубить свою благодарность за выкуп?	Ишԥаҳалшо аҿыхразы иааҳарԥшуа аџьшьара аизырҳара?
Как узнать мнение Иеговы?	Ишԥеилкаатәу Иегова игәаанагара?
Как финансируется деятельность Свидетелей Иеговы?	Иазҭода афинанстә цхыраара Иегова ишаҳаҭцәа инарыгӡо аус?
Как Финеес помог Иамину увидеть ситуацию в правильном свете?	Дышԥаицхрааи Финеес Иамин аҭагылазаашьа ииашаны ахәаԥшра?
Как христиане в наши дни могут мудро пользоваться периодом спокойствия?	Ишԥарылшо ақьырсианцәа иахьа аҭынчра аамҭа ҟәыӷарала ахархәара?
Как христианская любовь сплотила братьев и сестер в Германии и Южной Корее?	Ишԥеиднакылеи ақьырсиантә бзиабара Германиеи Аладатәи Кореиеи инхо аишьцәеи аиҳәшьцәеи?
Как царь Аса и ранние христиане пользовались периодом спокойствия?	Рхы ишԥадырхәоз аҭынчра аамҭа аҳ Асеи раԥхьатәи ақьырсианцәеи?
Как эта мысль может воодушевить тебя, если ты уже не можешь делать в служении столько, сколько раньше из-за плохого здоровья или упадка сил?	Угәы шԥашьҭнахуеи ари азхәыцра амаҵзураҿы уаанӡа еиԥш ирацәаны иузыҟамҵозар, угәабзиара ахьыԥсыҽхаз, ма умч ахькәадахаз иахҟьаны?
КАК ЭТИ СТИХИ ПОМОГАЮТ НАМ БОРОТЬСЯ С УНЫНИЕМ?	ИШԤАҲАЦХРААУЕИ АРҬ АЖӘЕИНРААЛАҚӘА АГӘКАҲАРА АИААИРА?
Как 15-я глава Первого письма коринфянам укрепляет вашу веру в воскресение?	Ишԥарӷәӷәо аԥсҭаларахь шәыгәрахаҵара 1 Коринфаа рахь 15-тәи ахы?
Как я могу прославлять Иегову пением?	Ишԥасылшо ашәаҳәарала Иегова ирҳаракра?
Какая жизнь ждет великое множество после Армагеддона?	Иарбан зеиԥшыҟам ԥсҭазаароу ҵҩа змам ажәлар ироуа арыцҳара ду ашьҭахь?
Какие возможности в служении открылись перед этими сестрами-пионерами?	Иарбан лшарақәоу амаҵзураҿы дара ирзаатыз?
Какие возможности в служении открыты для тебя?	Иарбан лшарақәоу амаҵзураҿы уара узы иҟоу?
Какие могут быть неправильные мотивы для поста?	Иарбан ииашам мотивқәоу ачгаразы иҟалар алшо?
Какие обязанности возложены на главу семьи?	Иарбан ҭакԥхықәрақәоу аҭаацәара ахада иду?
Какие плоды приносят смирение и скромность?	Иарбан хәарҭоу ахынраалара иаҳзаанаго?
Какие поставить цели?	Иарбан хықәкқәоу иқәшәыргылар шәылшо?
Какие правила в браке Иегова установил для супругов?	Иарбан ԥҟарақәоу хаҵеи-ԥҳәыси рзы Иегова ишьақәиргылаз?
Какие препятствия мешают нам ходить в истине?	Иаҳԥырхагахар алшозеи аҵабырг мҩала ацара?
Какие радости приносит миссионерское служение?	Иарбан гәырӷьароу амиссионертә маҵзура иаанаго?
Какие темы интересны людям в вашей местности?	Иарбан темақәоу шәахьынхо аҭыԥ аҿы ауаа еиҳа зинтерес рымоу?
Какие трудности могут возникнуть в браке, даже если начало было гладким?	Иарбан уадаҩрақәоу аҭаацәалазаараҿы ицәырҵыр алшо, раԥхьа зегь шыбзиазгьы?
Какие трудности могут лишить нас радости?	Иарбан уадаҩрақәоу агәырӷьара ҳамызхыр алшо?
Какие трудности преодолели три родные сестры, чтобы стать пионерами?	Иарбан уадаҩрақәоу х-ҩык аиҳәшьцәа ирхыргаз, пионерс аҟаларазы?
какие у нас есть обязанности перед Иеговой;	иарбан ҭакԥхықәрақәоу Иегова иҿаԥхьа иҳамоу;
КАКИЕ У НАС ЕСТЬ ПРЕПЯТСТВИЯ?	ИАҲԤЫРХАГАХАР АЛШОЗЕИ АҴАБЫРГ МҨАЛА АЦАРА?
Какие хорошие качества были у Джейд?	Иарбан ҟазшьа бзиақәоу Џьеид илымаз?
Какие шесть советов помогут нам сохранять спокойствие?	Иарбан шьаҿақәоу агәҭынчра ахьчара иҳацхраауа?
Каких благословений нового мира ты особенно ждешь?	Иарбан зылԥхарақәоу адунеи ҿыц аҿы иҟало рҟынтә уара еиҳарак уззыԥшу?
Какого «города» ждал Авраам?	Иарбан «қалақьу» Авраам дыззыԥшыз?
«Какое развлечение выбрать?»	«Иарбан гәырҿыхагоу иалхтәу?»
Какое техническое новшество стали использовать Исследователи Библии в 1914 году, чтобы укрепить доверие людей к Библии, и с каким успехом?	Иарбан иҿыцу мыругоу Абиблиа аҭҵааҩцәа рхы иадырхәо иалагаз 1914 шықәсазы, Абиблиахь ауаа рыгәрагара еиздырҳарц азы, насгьы лҵшәас иаанагазеи уи?
Какой подход поможет сделать изучение Библии более плодотворным?	Иҟаҳҵалар акәзеи Абиблиа ҳахьаԥхьо еиҳаны ахәарҭа ҳзаанагаларц азы?
Какой ты человек?	Узеиԥш уаҩузеи уара?
Какой у нас должен быть настрой?	Иарбан гәазыҟашьоу иҳамазар ахәҭоу?
КАКУЮ РАДОСТЬ ПРИНЕСЕТ НАМ ВОСКРЕСЕНИЕ?	ИАРБАН ГӘЫРӶЬАРОУ АԤСҬАЛАРА ИАҲЗААНАГО?
Когда мы поддерживаем воспитательные меры Иеговы, мы проявляем любовь	Ҳара Иегова иааӡаратә методқәа ҳанрықәныҟәо, абзиабара ааҳарԥшуеит
когда мы слышим недостоверную информацию?	цқьа иаҳзымдыруа аинформациа анҳаҳауа?
Кого назначают миссионерами?	Ирышьҭуада миссионерс амаҵ аура?
«Крепкая семья строится на любви и уважении»	«Абзиабареи аҳаҭырқәҵареи аҭаацәара еиднакылоит»
«Кто Автор Библии?»	«Дызусҭада Абиблиа автор?»
Личное имя Бога входит в состав некоторых библейских географических названий, однако они не являются дополнительными именами Бога.	Абиблиаҿы Анцәа ихатәы хьӡы агеографиатә ҭыԥқәа рыхьӡқәа ирыдҳәаланы иануп, аха уи иаанагаӡом Анцәа даҽа хьыӡқәак имоуп ҳәа.
любить братьев и сестер?	аишьцәеи аиҳәшьцәеи рахь абзиабара?
любить Иегову?	Иегова иахь абзиабара?
любить наших врагов?	ҳаӷацәа рахь абзиабара?
Метод кнута лишь все усугубит. Если заставлять ребенка учиться, это добавит ему стресса не только в школе, но и дома! Чтобы защититься, он может начать врать, скрывать плохие отметки, подделывать в дневнике вашу подпись или прогуливать уроки. Все станет только хуже.	Ахәыҷы иқәыӷәӷәара ауадаҩра заӡбом. Ахәыҷы аҵара мчыла идуцалалар, уи ашкол аҿы адагьы, аҩнгьы ауадаҩрақәа изцәырнагоит! Ихы ириашарц азы амц аҳәара далагар илшоит, иҽеим ахәшьарақәа иҵәахлар ауеит, амшынҵаҟны шәнапынҵа ихала ианиҵар илшоит, мамзаргьы аурокқәа бжьаижьуа далагар ҟалоит. Уи иахҟьаны аҭагылазаашьа еиҳа еицәахоит.
«Милосердный и великодушный». Иегова нежно заботится о своих служителях, подобно тому как любящие родители заботятся о своих детях.	«Агәрыцҳашьареи агәыҭбаареи злоу». Иегова ахаара аарԥшны имаҵзуҩцәа дрыхӡыӡаауеит, абзиабара аазырԥшуа аҭаацәа рхәыҷқәа ишрыхӡыӡаауа еиԥш.
«Мне надоел мой образ жизни»	«Сара сыԥсҭазаашьа сгәы ԥнаҵәеит»
Многие юноши и девушки научились уравновешенно относиться к электронным играм. Вот что говорят двое из них.	Арԥарцәеи аҭыԥҳацәеи аӡәырҩы аелектронтә хәмаррақәа ииашаны рызнеишьа рҵеит. Абар ҩ-ҿырԥштәык.
Могут возникать проблемы в семье.	Аҭаацәараҿы ауадаҩрақәа цәырҵыр алшоит.
МОЖЕТЕ ЛИ ВЫ ОБЪЯСНИТЬ ЭТИ ПРОРОЧЕСТВА?	Ишәылшома арҭ аԥааимбаражәақәа ҳаилшәыркаар?
Можешь ли ты жертвовать Иегове свое время и силы?	Иулшома уара уаамҭеи умчи Иегова изкра?
Можно пройти обучение по обслуживанию Зала Царства.	Аҳратә зал амаҵ ауразы иҟоу арҵара уахысыр улшоит.
Можно участвовать в уборке Зала Царства, когда дежурит твоя группа для проповеднического служения.	Иулшоит Аҳратә зал аилыргара уҽалаурхәыр, уара узҵазкуа ажәабжьҳәаратә гәыԥ ианеилдырго.
Мы твердо уверены в воскресении!	Ҳара аԥсҭалара шыҟало агәра ҳгоит!
на встречах для проповеднического служения?	ажәабжьҳәаратә еиԥыларақәа рҿы?
НА ИЛЛЮСТРАЦИИ: Аса лишил свою бабушку звания царицы за то, что она поощряла народ поклоняться идолу. Сторонники Асы по его приказу уничтожают идолов.	АСАХЬАҾЫ ИАҲБО: аҳ Аса ианду лаҳкәажәра лымихит, ажәлар аныхақәа ирымҵахырхәаларц ргәы ахьазҭалҵоз азы. Аса идгылаз ауаа иара иҿыԥшны аныхақәа ԥырҽуеит.
НА ИЛЛЮСТРАЦИИ: на работе брата настойчиво приглашают отметить день рождения одного из сотрудников.	АСАХЬАҾЫ ИАҲБО: Аиашьа аус ицызуа амшира рыцазгәеиҭарц идыргалоит.
НА ИЛЛЮСТРАЦИИ: тоска по прошлому, обида и чрезмерное чувство вины подобны тяжелому грузу, который мы тянем за собой и который мешает нам идти по дороге, ведущей к жизни.	АСАХЬАҾЫ ИАҲБО: анкьа иҟаз гәхьааҳгозар, аӡәы ҳицәгәааны ҳаҟазар, ма мыцхәы ҳхы ахара адаҳҵозар, аԥсҭазааратә мҩала ацара иаҳԥырхагоу аидара хьанҭа ҳаҵоушәа иаҩызоуп.
НА ИЛЛЮСТРАЦИЯХ: Иисус перенимал у Иосифа трудовые навыки. В наши дни юным тоже важно учиться у своих отцов.	АСАХЬАҚӘА РҾЫ ИАҲБО: Иисус иаб ауасҭашьа иҿиҵаауан. Иахьагьы аҿар рабацәа напҟазарак рҿырҵаалар рылшоит.
НА ИЛЛЮСТРАЦИЯХ. Три христианина не поддаются искушению: один отворачивается от неподобающего изображения, другой отказывается закурить, а третий не берет взятку.	АСАХЬАҾЫ ИАҲБО. Аишьцәа ахыхрақәа ирҿагылоит: руаӡәк иҽеим асахьа илаԥш аҟәигоит, егьи аҭаҭын ахара мап ацәикуеит, ахԥатәи аҵарҭыша игаӡом.
На какие грани христианской любви обратили внимание члены Руководящего совета?	Иарбан ақьырсиантә бзиабара иамоу ганқәоу Анапхгаратә хеилак еиҳарак иззааҭгылаз?
На каких языках говорят люди в вашей местности?	Иарбан бызшәақәоу шәахьынхо аҭыԥ аҿы излацәажәо?
На каком этапе на пути к крещению находишься ты?	Уабанӡанеихьо аӡӡаахрахь узну амҩаҿы?
На следующий же день президент Вудро Вильсон помиловал сестру Мартин, а также братьев Хамма, Сонненбурга и Стивенса. Их несправедливому заключению пришел конец.	Адырҩаҽныҵәҟьа апрезидент Вудро Вильсон аиаҳәшьа Мартини аишьцәа Ҳемми, Сонненбурги, Стивенси аурышьҭырц азы адҵа ҟаиҵеит. Убасала дара аушьҭын.
на случай чрезвычайной ситуации?	ҳазқәымгәыӷуа аҭагылазаашьақәа ҳанрықәшәо?
на случай экстренной медицинской помощи?	иаалырҟьаны аҳақьымцәа рыцхыраара анаҳҭаххо?
НАГРУДНИК. Праведные нормы Иеговы	Агәышԥыхьчага. Иҳараку Иегова инормақәа
Над чем стоит подумать:	Изызхәыцтәу:
Назови некоторые особенности этого приложения.	Еиқәыԥхьаӡа ари апрограмма иамоу лшарақәак.
НАЙДИ ЭТИ СТИХИ В ИНСТРУМЕНТАХ ДЛЯ СЛУЖЕНИЯ:	ИԤШАА АРҬ АЖӘЕИНРААЛАҚӘА АМАҴЗУРАЗЫ ИҞОУ АМЫРУГАҚӘА РҾЫ:
НАЙДИ ЭТОТ СТИХ В ИНСТРУМЕНТАХ ДЛЯ СЛУЖЕНИЯ:	ИԤШАА АРИ АЖӘЕИНРААЛА АМАҴЗУРАЗЫ ИҞОУ АМЫРУГАҚӘА РҾЫ:
Нам нужно с готовностью прощать своих обидчиков.	Ҳгәы ҳзырхьуа ранажьра ҳазхиазароуп.
«НАПОМИНАЮ ТЕБЕ КАК ОГОНЬ РАЗЖИГАТЬ ДАР»	«АНЦӘА ИУЛЕИҴАЗ АҲАМҬА АМЦА ЕИԤШ ИЖЖАӠА ИАРКНЫ ИУМАЗ»
Наша жизнь в надежных руках Иеговы.	Ҳаԥсҭазаара Иегова инапы иануп.
Наша совесть показывает, какие мы на самом деле и что для нас по-настоящему важно. А что твоя совесть может рассказать о тебе?	Ҳаламыс иаанарԥшуеит ҳара ҳзы ихадоу закәу, насгьы ҳзеиԥшраҵәҟьоу. Иаанарԥшуазеи уара уламыс?
«Наша христианская жизнь и служение». Рабочая тетрадь. Август 2020	«Ҳқьырсиантә ԥсҭазаареи ҳмаҵзуреи». Аусуратә тетрад. Август 2020
«Наша христианская жизнь и служение». Рабочая тетрадь. Декабрь 2020	«Ҳқьырсиантә ԥсҭазаареи ҳмаҵзуреи». Аусуратә тетрад. Декабр 2020
«Наша христианская жизнь и служение». Рабочая тетрадь. Июль 2020	«Ҳқьырсиантә ԥсҭазаареи ҳмаҵзуреи». Аусуратә тетрад. Ииуль 2020
«Наша христианская жизнь и служение». Рабочая тетрадь. Ноябрь 2020	«Ҳқьырсиантә ԥсҭазаареи ҳмаҵзуреи». Аусуратә тетрад. Ноиабр 2020
«Наша христианская жизнь и служение». Рабочая тетрадь. Октябрь 2020	«Ҳқьырсиантә ԥсҭазаареи ҳмаҵзуреи». Аусуратә тетрад. Октиабр 2020
«Наша христианская жизнь и служение». Рабочая тетрадь. Сентябрь 2020	«Ҳқьырсиантә ԥсҭазаареи ҳмаҵзуреи». Аусуратә тетрад. Сентиабр 2020
«Наша христианская жизнь и служение». Расписание чтения Библии на 2018 год	«Ҳқьырсиантә ԥсҭазаареи ҳмаҵзуреи». 2018 шықәсазы Абиблиа аԥхьара аихшанҵа
Не влияют ли компьютерные игры на твое мышление?	Ианыруама ухәыцшьа акомпиутертә хәмаррақәа?
«Не давай отдыха своей руке»	«Унапы аԥсшьаха аумҭан»
Не крадут ли компьютерные игры у тебя время?	Иуцәырӷьычуама акомпиутертә хәмаррақәа уаамҭа?
Не прогуливай занятия.	Аурокқәа бжьоумыжьлан.
Не сравнивай себя с другими.	Егьырҭ ухы рҿумырԥшлан.
Не сравнивай себя с другими. Если тебя не позвали на вечеринку, не принимай это близко к сердцу.	Егьырҭ ухы рҿумырԥшлан. Уара аиԥыларатә ахәылԥаз ахь ааԥхьара урымҭазар, хьаас иҟаумҵан.
Не хитри.	Амц умҳәалан.
недвижимость,	еиҭамҵуа амал,
Некоторые гебраисты предпочитают передавать Божье имя как «Яхве».	Аӡәырҩы аиудеиатә ҵарауаа Анцәа ихьӡ «Иахве» ауп рҳәоит.
Некоторые имена изменены.	Хьыӡқәак ԥсахуп.
Но в 16-м стихе речь идет о другом.	Аха 16-тәи ажәеинраалаҿы зыӡбахә ҳәоу уи акәӡам.
Новостные ленты пестрят сообщениями о военных конфликтах, терактах и преступлениях.	Ажәабжьқәа рҿы аибашьрақәеи, атерроризми ма ацәгьоурақәеи ирызку аацҳарақәа рыда акгьы уаҳаӡом.
О каком служителе Иеговы библейских времен вам хотелось бы узнать больше?	Абиблиаҿы зыӡбахә ану ауаа рҟынтә еиҳаны зыӡбахә еилышәкаар шәҭахыда?
О чем нужно спросить себя, прежде чем говорить о ком-то?	Иарбан зҵаароу ҳхы иаҳҭар ҳахәҭоу, аӡәы иӡбахә аҳәара ҳалагаанӡа?
ОБУВЬ. Готовность проповедовать благую весть	Ашьапымаҭәа. Ауаа ажәабжь бзиа рылаҳәара ҳазхиоуп
«Одобряет ли Бог все религии?»	«Дырзыразума Анцәа адинхаҵарақәа зегьы?»
Одри Хайд сохраняла положительный настрой, думая о будущей награде	Одри Ҳаид ԥхьаҟатәи лԥеиԥш дазхәыцуан, уи ауадаҩрақәа рыхгара илыцхраауан
«Оставайся в любви Бога»	«Анцәа ибзиабараҿ шәыҟаз»
«ОСТАВАЙТЕСЬ В МОЕЙ ЛЮБВИ»	«СЫБЗИАБАРАҾ ШӘЫҞАЗ»
Отправляемся с Алексом на неназначенную территорию, чтобы приглашать людей на Вечерю	Алекси сареи аизарақәа ирыдым атерриториахь ҳцоит, ауаа Ахәылԥаз ахь ааԥхьара раҳҭарц азы
ОТТАЧИВАЕМ НАВЫКИ СЛУЖЕНИЯ | ПРОПОВЕДУЙ С РАДОСТЬЮ	АМАҴЗУРАҾЫ ИҲАМОУ АҞАЗАРА ЕИӶЬАҲТӘУЕИТ | ГӘЫРӶЬАРЫЛА АЖӘАБЖЬ ҲӘАЛА
ПЕСНЯ 126 Будьте бодры, стойки и твёрды	АШӘА 126 Ӷьеҩла шәыҟаз, акрычҳара шәымаз
ПЕСНЯ 109 «Горячо любите друг друга»	АШӘА 109 «Бзиа шәеибабала гәык-ԥсыкала»
ПЕСНЯ 40 Кому принадлежишь?	АШӘА 40 Дызусҭада узтәу?
ПЕСНЯ 3 Наша сила, наша надежда, наша уверенность	АШӘА 3 Ҳара ҳамч, ҳгәыӷра, ҳагәрагара
ПЕСНЯ 55 Не бойтесь их!	АШӘА 55 Урҭ шәырцәымшәан!
ПЕСНЯ 74 Подхватите песню Царства!	АШӘА 74 Иацышәҳәа Аԥсҳара ашәа!
ПЕСНЯ 22 Пусть придет Царство Бога!	АШӘА 22 Иааиааит Анцәа Иԥсҳара!
ПЕСНЯ 14 Славьте нового Царя земли!	АШӘА 14 Ихьӡ ҳарашәкла адгьыл Аҳ ҿыц!
ПЕСНЯ 15 Славьте Первенца Иеговы!	АШӘА 15 Иегова Иԥхьахшаа дҳарашәкла!
ПЕСНЯ 31 Ходи с Богом!	АШӘА 31 Анцәа уицыз!
ПЕСНЯ 131 «Что Бог соединил одним ярмом»	АШӘА 131 «Убас Анцәа иеидикылаз»
ПЕСНЯ 76 Что ты чувствуешь?	АШӘА 76 Цәаныррас иумоузеи?
Погубят ли люди Землю?	Иқәырхуама ауаа Адгьыл?
поддерживать порядок и мир в собрании?	аиҿкаареи аҭынчреи еизырҳауа амаҵ аицура?
поддерживать решения организации Иеговы?	Анцәа иорганизациа иаҳнаҭо анапхгара ақәныҟәара?
Подумай, кто твои друзья.	Уазхәыц, уҩызцәа зусҭцәоу.
Подытожим. Как перестать видеть все в мрачном свете?	Алкаа. Ишԥасылшо иҽеим ахәыцра аҽацәыхьчара?
Подытожим. Как повысить успеваемость?	Алкаа. Ишԥасылшо ашкол аҿы сеихьӡарақәа еиӷьыстәыр?
Позже Гранвилл побудил меня записаться в Школу теократического служения. Он сказал: «Ходить ты не можешь, но ты можешь говорить. Когда-нибудь ты выступишь с публичной речью. Обязательно выступишь!» Его слова придали мне уверенности.	Ԥыҭрак ашьҭахь Гранвилл Атеократиатә маҵзура ашкол сыҽҭазҩырц сгәазҭеиҵеит. Иара иҳәеит: «Уара узныҟәаӡом, аха ацәажәара улшоит. Ҽнак зны иаарту ажәахә уманы уқәгылоит. Хымԥада уқәгылоит!» Иажәақәа сгәы дырӷәӷәеит.
пользуясь социальными сетями?	асоциалтә каҭақәа шәхы ианашәырхәо?
Помните ли вы?	Ишәгәалашәома шәара?
Попробуй записать себя на камеру своего телефона и затем посмотри, как ты выглядишь.	Уҽазышәа уҭел акамера ала уҽҭаҩра, анаҩс ишузалҵыз уахәаԥш.
Почему важно говорить изучающему о посвящении и крещении?	Избан Анцәа иҽизкреи аҽӡаахреи шхадоу ауаҩы иаҳҳәалар закәу?
Почему важно поддерживать со своими детьми открытое общение?	Избан ҳхәыҷқәа ауадаҩра рызцәырҵаанӡа заа рацәажәара зҳахәҭоу?
Почему во время Армагеддона нам потребуется мужество?	Избан Армагеддон аан агәымшәара заҳҭаххо?
Почему воскресение Иисуса имеет для нас такое большое значение?	Избан Иисус иԥсҭалара ҳара ҳзы акыр заҵанакуа?
Почему глупо следовать за большинством:	Избан аиҳараҩык рган аанкылара зыхшыҩдароу:
Почему даже в собрании нужно внимательно подходить к выбору близких друзей?	Избан аизараҿгьы аҩызцәа ҟәыӷарала изалхлатәу?
Почему Иегова создал жизнь?	Избан Иегова аԥсҭазаара зишаз?
«Почему Иисус умер?»	«Избан Иисус дзыԥсыз?»
Почему Иисусу нужно было пройти через мучительные испытания и смерть?	Избан Иисус дгәаҟны дыԥсыр закәыз?
Почему их преследовали?	Избан дара изрышьҭашәарыцоз?
Почему мангуст не боится ядовитых змей?	Избан амангуст ашҳам змоу амаҭқәа изырцәымшәо?
Почему мы так любим наши ежегодные региональные конгрессы? Подобно ежегодным праздникам в древнем Израиле, такие конгрессы позволяют нам поклоняться Иегове вместе с сотнями, а иногда даже тысячами соверующих. Нас всегда ждет обильное угощение на щедро накрытом духовном столе. Еще нам очень нравится встречаться на конгрессах с нашими друзьями и родственниками. Поэтому мы не хотим пропустить ни одного дня этого духовного праздника.	Бзиа изаҳбозеи есышықәсатәи ҳрегионалтә конгрессқәа? Ажәытә Израиль аҿы иҟаз есышықәсатәи аныҳәақәа реиԥш, арҭ аконгрессқәа шәҩыла, ма зықьҩыла ҳхаҵара ҳацеиҩызшои ҳареи Иегова имҵахырхәара алшара ҳарҭоит. Ҳара еснагь адоуҳатә фатә рацәаны иаҳзыԥшуп. Иара убас ҳара иаҳгәаԥхоит урҭ аконгрессқәа рҿы ҳҩызцәеи ҳҭынхацәеи рбара. Убри аҟынтә иаҳҭахӡам мышкгьы бжьаҳажьыр.
Почему нам важно помнить слова из текста на 2021 год?	Избан 2021-тәи ашықәс иақәнагаҵәҟьоу ажәеинраала азалхуп ҳәа ҳҳәар зҳалшо?
Почему некоторые родители стесняются разговаривать со своими детьми о сексе?	Избан аҭаацәа шьоукы рхәыҷқәа ацәеижьтә еизааигәахара иазкны рацәажәара изацәыԥхашьо?
Почему нужно избегать жадности и идолопоклонства?	Избан аԥсыцәгьареи амцмҵахырхәареи аҽацәыхьчара заҭаху?
Почему перед смертью Иисус процитировал слова Давида из Псалма 22:1?	Избан Иисус даныԥсуаз Аԥсалом 22:1 иану Давид иажәақәа зиҳәаз?
Почему Свидетели Иеговы не празднуют дни рождения?	Избан Иегова ишаҳаҭцәа амширақәа зазгәарымҭо?
Почему христианин может оставаться радостным?	Ирзаазгозеи ақьырсианцәа агәырӷьара?
Почему это важно?	Изхадоузеи уи?
ПОЯС. Истины из Слова Бога	Амаҟа. Анцәа Иажәа иану аҵабырг
«Правдоподобна ли эта новость?» Не спеши верить сенсационным сообщениям и рассказам.	«Ииашоу жәабжьума уи?» Ажәабжь ҿыцқәеи аацҳарақәеи рыгәрагара уахымыццаклан.
Правильно относись к своим промахам.	Иҟауҵо агхақәа ииашаны урызнеила.
Правильно относись к своим промахам. Работай над собой, но не ожидай от себя совершенства.	Иҟауҵо агхақәа ииашаны урызнеила. Угхақәа аус рыдулала, аха анаӡара уазымԥшын.
Предопределено ли время нашей смерти?	Ҳалахь ианума ҳанԥсуа аамҭа?
Предоставь все необходимое для выполнения задания.	Адҵа анагӡаразы иаҭаху зегь рыҭ.
Представляй себя в новом мире!	Адунеи ҿыц аҿы уҟоушәа ухаҿы иаагала!
Приведи примеры того, как нас защищает послушание Иегове.	Иаага аҿырԥштәқәа, Иегова изыӡырҩра ҳшахьчо узырбо.
проповедовать людям всякого рода?	ауаа еилымхӡакәа зегьы ажәабжь рзеиҭаҳәара?
«Противостаньте Дьяволу»	«Аџьныш шәиҿагыл»
«Противостой давлению сверстников!»	«Уқәлацәа рықәыӷәӷәара уаҿагыл!»
Проявляй инициативу.	Иҟоу алшарақәа ухы иархәала.
проявлять терпение?	ачҳара ааҳарԥшуазар?
Радуйте сердце Иеговы!	Иегова дшәыргәырӷьала!
Рамка, пункт 4. «Бывшие враги становятся друзьями»	Арамка, апункт 4. «Уаанӡа еиӷацәаз еиҩызцәахеит»
Рамка, пункт 3. «В то время как близится буря, держите взор на Иисусе! Будущие благословения Царства»	Арамка, апункт 3. «В то время как близится буря, держите взор на Иисусе! Будущие благословения Царства»
Рамка, пункт 3. «Есть ли надежда для умерших?»	Арамка, апункт 3. «Ирымоума иԥсхьоу агәыӷра?»
Рамка, пункт 3. «Почему Бог допускает страдания?»	Арамка, апункт 3. «Избан Анцәа агәаҟрақәа заанимкыло?»
Рамка, пункт 3. «Противостаньте Дьяволу»	Арамка, апункт 3. «Аџьныш шәиҿагыл»
Рамка, пункт 2. «Свидетельство тысячам. Проповедь в общественных местах в Сан-Франциско»	Арамка, апункт 2. «Свидетельство тысячам. Проповедь в общественных местах в Сан-Франциско»
Рамка, пункт 2. «Утоляем духовную жажду беженцев»	Арамка, апункт 2. «Утоляем духовную жажду беженцев»
Рамка, пункт 1. «Я был разочарован в религии»	Арамка, апункт 1. «Я был разочарован в религии»
Рассмотрим пять важных советов.	Еилҳаргап ихадоу хә-лабжьарак.
Родители, обучайте своих детей!	Аҭаацәа, шәхәыҷқәа адыррақәа рышәҭала!
С 1975 года в Восточном Тиморе 20 лет шла война за независимость.	шықәса инаркны Мрагыларатәи Тимор 20 шықәса ахьыԥшымразы аибашьра цон.
С головой уйти в гаджеты? Или же стоит расширить свои горизонты?	Аелектронтә хархәагақәа иахьахәлаанӡа иаҳкызароума? Мамзаргьы ҳахшыҩ ззаҳашьҭыша даҽакгьы ыҟоу?
С каким из следующих высказываний об электронных играх ты можешь согласиться?	Иарбан гәаанагароу аелектронтә хәмаррақәа ирызкны уара узықәшаҳаҭхар улшо?
С каким преследованием столкнулся брат Дмитрий Михайлов?	Ишԥаишьҭашәарыцоз аиашьа Дмитри Михаилов?
С какими трудностями столкнулся Авраам?	Иарбан уадаҩрақәоу Авраам дзықәшәоз?
с тоской по прошлому?	анкьа иҟаз агәхьаамгара?
С чем пришлось столкнуться Свидетелям Иеговы во время холокоста?	Изықәшәази Иегова ишаҳаҭцәа ахолокост аан?
с чрезмерным чувством вины?	мыцхәы ҳхы ахара адымҵара?
Сатана хочет помешать нам войти в обещанный Богом новый мир. Но принципы Иеговы могут уберечь нас от ловушек Сатаны.	Аҩсҭаа иҭахӡам Анцәа ҳзықәиргәыӷыз адунеи ҿыц ахь ҳнеирц. Аха Иегова ипринципқәа Аҩсҭаа ишьацҳәақәа рҟынтә ҳрыхьчоит.
«СВЕРШИЛОСЬ!»	«ИНАӠЕИТ!»
Свидетели Иеговы стараются придерживаться христианства в той форме, в какой его основал Иисус Христос и какую исповедовали апостолы. В этой статье кратко перечислены наши основные верования.	Иегова ишаҳаҭцәа реиԥш ҳара Христос ишьақәиргылаз, насгьы апостолцәа иныҟәыргоз ақьырсианра инақәыршәаны анхара ҳҽазаҳшәоит. Ари астатиаҿы ихадоу ҳхаҵарақәа еиқәыԥхьаӡоуп.
Святой дух помог Веселеилу и Аголиаву воплотить в жизнь указания Иеговы в отношении строительства священного шатра. Служители Иеговы и сегодня могут рассчитывать на помощь его мощного святого духа. Как получить эту силу?	Веселеили Аголиави иԥшьоу адоуҳа рыцхрааит иԥшьоу ақьала аргылара иадҳәалаз Иегова идҵақәа рынагӡара. Иегова ишаҳаҭцәа иахьагьы Иегова иԥшьоу идоуҳа амч ду иақәгәыӷлар рылшоит. Ишԥаҳаиҭо уи амч?
Священнические обязанности поручались мужчинам из рода Аарона. Остальные мужчины из племени Левия были их помощниками. Так же и сегодня в христианском собрании некоторым мужчинам поручены важные ответственные задания, а другие мужчины им помогают.	Аԥшьаҩцәа рҭакԥхықәра Аарон ихылҵшьҭра иатәыз ахацәа ирыдырҵон. Леви иеимшьҭра иатәыз егьырҭ ахацәа урҭ ирыцхраауан. Убас еиԥш иахьагьы ақьырсиантә еизарақәа рҿы ахацәа шьоукы ихадоу адҵақәа рыдуп, егьырҭ ахацәа дара ирыцхраауеит.
Сейчас рабочая тетрадь «Наша христианская жизнь и служение».	Уажәы Аусуратә тетрад «Ҳқьырсиантә ԥсҭазаареи ҳмаҵзуреи».
«Сейчас я не мыслю себя без служения!»	«Уажәшьҭа ажәабжьҳәара бзиа избоит!»
Серьезно относись к домашним заданиям.	Аҩныҟатәи адҵақәа ҭакԥхықәрала урызнеила.
Сколько имен у Бога?	Шаҟа хьӡы имоузеи Анцәа?
Служение по телефону не должно нарушать законы о защите персональных данных.	Ҭелла ажәабжьҳәара ауаҩы ихаҭара зыхьчо азакәан еиланамгозароуп.
«Слушает ли Бог все молитвы?»	«Дырзыӡырҩуама Анцәа аҳәарақәа зегьы?»
Слушать Иегову, ежедневно читая Библию	Есыҽны Абиблиа даԥхьалароуп, убас ала Иегова иара диацәажәалоит
Слушаясь назначенных братьев, мы тем самым слушаемся Иегову.	Аҭакԥхықәра змоу аишьцәа ханырзыӡырҩуа, уи ала ҳара Иегова ҳшизыӡыруа ааҳарԥшуеит.
Смотрите: Мецгер Б. М., Эрман Б. Д. Текстология Нового Завета. Рукописная традиция, возникновение искажений и реконструкция оригинала. 2-е изд., переработанное и дополненное. М., 2013. С. 290, 291.	Шәахәаԥш: Мецгер Б. М., Эрман Б. Д. Текстология Нового Завета. Рукописная традиция, возникновение искажений и реконструкция оригинала. 2-е изд., переработанное и дополненное. М., 2013. С. 290, 291.
Смотрите рамку «Почему Иоанн написал свои письма».	Шәахәаԥш арамка «Иоанн исаламшәҟәқәа зиҩыз».
Смотрите также абзацы 9 и 10 в статье «Чему нас учат последние слова Иисуса?» в этом выпуске.	Шәахәаԥш ари аҭыжьымҭаҿы иаагоу астатиа «Иаҳдырҵозеи Иисус аҵыхәтәантәи иажәақәа?» аҟны 9-тәи 10-тәи абзацқәа.
Совершенствуем навыки служения. Как проповедовать по домофону	Амаҵзураҿы иҳамоу аҟазара еиӷьаҳтәуеит. Адомофон ала ажәабжь шҳәалатәу
Совершенствуем навыки служения. Проповедуем по телефону	Амаҵзураҿы иҳамоу аҟазара еиӷьаҳтәуеит. Ҭелла ажәабжь ҳҳәоит
СОКРОВИЩА ИЗ СЛОВА БОГА | ИСХОД 6, 7	АНЦӘА ИАЖӘА АҞЫНТӘ АХАЗЫНАҚӘА | АҚӘҴЫМҬА 6, 7
сохранять крепкую веру?	ҳагәрахаҵара ҳарӷәӷәозар?
СПРОСИ СЕБЯ: «В каких ситуациях мне потребуется мужество, чтобы не быть как все?»	УХЫ УАЗҴАА: «Иарбан ҭагылазаашьақәоу агәымшәара ахьысҭаххо, зегьы среиԥшымхарц азы?»
СПРОСИ СЕБЯ: «Как я могу подражать Иегове в милосердии и сострадании?»	УХЫ УАЗҴАА: «Сиҿыԥшлар шԥасылшо Иегова агәыҭбаареи агәрыцҳашьареи раарԥшраҿы?»
СПРОСИ СЕБЯ: «Какие обязанности я мог бы передать другим?»	УХЫ УАЗҴАА: «Иарбан дҵақәоу егьырҭ рнапы ианысҵар сылшо?»
СПРОСИ СЕБЯ: «Каких видов медицинского лечения нужно избегать, чтобы не огорчить Иегову?»	УХЫ УАЗҴАА: «Иарбан медицинатә хәышәтәышьақәоу ҳҽызцәыҳахьчалар ҳахәҭоу, Иегова игәы иаҳмырхьырц азы?»
СТАРЕЙШИНЫ, ПРОЯВЛЯЙТЕ ВЗАИМНОЕ УВАЖЕНИЕ	АИЗАРА АИҲАБАЦӘА, ҲАҬЫР ЕИҚӘЫШӘҴАЛА
страховые выплаты,	аԥгаԥсатә аҭара,
Стремись к миру, особенно в семье.	Аҭынчра аарԥшла, еиҳараӡак уҭаацәараҿы.
Считается ли курение грехом?	Гәнаҳароума аҭаҭын ахара?
Тем, что опытные братья обучают более молодых братьев и передают им часть своих обязанностей, они проявляют скромность, любовь и дальновидность. Как обучать других?	Аԥышәа змоу аишьцәа еиҳа иқәыԥшу аишьцәа рԥышәа анрыцеиҩыршо, насгьы рыдҵақәа рҟынтә хәҭак урҭ рнапы иананырҵо, дара ахӡырымгареи абзиабареи аадырԥшуеит, иара убас ԥхьаҟа ихәыцуеит. Ишԥаҟаҵатәу уи?
«Теперь ты увидишь, что я сделаю с фараоном»	«Уажәшьҭа уара иубоит, сара афараон изызуа»
точку зрения Иеговы по разным вопросам;	еиуеиԥшым азҵаарақәа рыла Иегова ихәаԥшышьа;
«ТЫ БУДЕШЬ СО МНОЙ В РАЮ»	«УАРА ЏЬАНАҬ УСЫЦҞАЛОИТ»
У нас есть прекрасная духовная семья.	Ҳара зеиԥшыҟам адоуҳатә ҭаацәара ҳахәҭакуп.
У НАС ТВЕРДАЯ НАДЕЖДА!	ҲГӘЫӶРА ХЫМԤАДА ИНАӠОИТ!
«Убегайте от блуда»	«Акалҭбааԥсра шәҽацәышәыхьчала»
Узнайте ответы на эти вопросы:	Еилышәкаа арҭ азҵаарақәа рҭак:
Утверждение. Апостолы Иисуса и другие первые ученики верили, что святой дух является личностью.	Ашьақәырӷәӷәара. Иисус иапостолцәа, насгьы егьырҭ раԥхьатәи иҵаҩцәа иԥшьоу адоуҳа хаҭароуп ҳәа агәра ргон.
Утверждение. Христиане должны поститься в память о смерти Христа.	Ашьақәырӷәӷәара. Ақьырсианцәа чгалароуп Христос иԥсра амш ргәаладыршәаларц азы.
Утверждение. Христиане должны поститься, потому что Иисус постился 40 дней в пустыне после своего крещения.	Ашьақәырӷәӷәара. Ақьырсианцәа чгалароуп, избанзар Иисус аӡы иҽанӡааих ашьҭахь 40 мшы ацәҳәыраҿы дычгон.
Учись быть благодарным.	Аџьшьара аарԥшла.
«Учитесь отвергать плохое общение»	«Иҽеим аиҿцәажәара мап ацәкышьа шәҵала»
учиться библейским истинам и обучать им других?	Иегова иҳаиҭо арҵара ахәарҭа алхра?
Хорошо ли вы понимаете принцип главенства в собрании?	Иарбан мчроу аизара аиҳабацәа ирымоу?
Хотел бы ты пройти обучение в Школе благовестников Царства?	Иуҭахума уара Аҳра ажәабжьҳәаҩцәа рышкол аҿы аҵара ахысра?
«Храни доверенное тебе»	«Угәы-уԥсы ирҭаҵәахны иумаз абри иуаҭәашьоу»
Царство Бога сделает землю раем!	Анцәа Иаҳра адгьыл џьанаҭны иҟанаҵоит!
Чем власть старейшины отличается от власти главы семьи?	Излеиԥшымзеи аҭаацәара ахадацәеи аизара аиҳабацәеи ирымоу амчра?
Чем занимаются миссионеры?	Иҟарҵозеи амиссионерцәа?
Чем обычно хвастаются люди?	Изхыҽхәозеи абжьааԥны ауаа?
Чем опасно недовольство?	Излашәарҭоузеи агәынамӡара?
Чем хвастался Коля перед своим другом?	Дызхыҽхәози Ахра иҩыза иҿаԥхьа?
Чему вас научил пример апостола Иоанна?	Иаҳнарҵозеи Иоанн иҿырԥшы?
Чему вас научил пример царя Давида и апостола Павла?	Иаҳдырҵозеи аҳ Давиди апостол Павели рҿырԥштәқәа?
ЧЕМУ ВАС УЧАТ ЭТИ СТИХИ?	ИШӘДЫРҴОЗЕИ ШӘАРА АБАРҬ АЖӘЕИНРААЛАҚӘА?
ЧЕМУ НАС УЧАТ ДРУГИЕ ПРИМЕРЫ?	ИАҲДЫРҴОЗЕИ ЕГЬЫРҬ АҾЫРԤШТӘҚӘА?
Чему нас учат последние слова Иисуса?	Иаҳдырҵозеи Иисус аҵыхәтәантәи иажәақәа?
«Чему нас учит Библия?»	«Иаҳнарҵозеи Абиблиа?»
ЧЕМУ НАС УЧИТ ПРИМЕР ИЕГОВЫ?	ИАҲНАРҴОЗЕИ ИЕГОВА ИҾЫРԤШТӘЫ?
Чему о теплоте и нежных чувствах вас учит пример Иеговы, а также дружба Ионафана и Давида?	Иаҳнарҵозеи абзиабара иазкны Иегова иҿырԥшы, насгьы Ионафани Давиди рҿырԥшы?
Чему учит тебя смиренный ответ Сергея?	Иунарҵозеи уара ахынраалара зныԥшуаз Сергеи иҭак?
Чему христиане могут научиться у опытных рыбаков?	Иҿырҵаар рылшозеи ақьырсианцәа аԥсыӡкҩы бзиа?
Чему эти стихи учат нас в отношении пожертвований, которые идут на поддержку истинного поклонения?	Иаҳдырҵозеи арҭ ажәеинраалақәа, ииашоу амҵахырхәара ацхраарахь ирышьҭуа аҭарақәа рганахь ала?
Чему юные христиане могут научиться у Иисуса?	Иднарҵозеи ақьырсиантә ҿар Иисус идикылоз аӡбарақәа?
Читайте на сайте jw.org	Асаит jw.org аҿы ишәыԥшаар шәылшо
Что Бог приготовил для людей?	Игәы иҭеикзеи Анцәа ҳара ҳзы?
Что было неправильного в их похвале?	Иҟарҵазеи ииашамкәа дандырҽхәоз?
Что в Библии говорится о кремации?	Иаҳәозеи Абиблиа акремациа иазкны?
Что в Библии говорится о любви к себе?	Иаҳәозеи Абиблиа ахбзиабара иазкны?
ЧТО ВЫ УЗНАЛИ?	ЕИЛЫШӘКААЗЕИ ШӘАРА?
ЧТО ВЫБЕРЕТЕ ВЫ?	ИАЛШӘХУАЗЕИ ШӘАРА?
Что говорится в Библии о посте?	Иаҳәозеи Абиблиа ачгара иазкны?
Что же тогда имел в виду Павел?	Нас ииҳәарц ииҭахызи Павел?
Что значит быть святым?	Иаанагозеи иԥшьаны аҟазаара?
Что значит посвятить себя Иегове и креститься?	Иаанагозеи Иегова иҽизкреи аҽӡаахреи?
Что значит следовать по стопам Иисуса?	Иарбан ҿырԥшу Иисус иаҳзынижьыз?
ЧТО ЗНАЧИТ ХОДИТЬ В ИСТИНЕ?	ИААНАГОЗЕИ АҴАБЫРГ МҨАЛА АЦАРА?
Что значит ходить в истине?	Иаанагозеи аҵабырг мҩала ацара?
Что изменилось в использовании видеороликов с 2014 года?	Зҽызыԥсахзеи 2014 шықәса раахыс авидеонҵамҭақәа рхархәараҿы?
Что им помогло?	Ирыцхраазеи дара?
Что мешает мне заниматься спортом?	Исԥырхагоузеи сара абаҩрҵәыра аҟаҵара?
Что мне следует знать об электронных играх?	Издыруазар сыхәҭоузеи аелектронтә хәмаррақәа ирызкны?
Что нас ждет в ближайшем будущем?	Иарбан хҭысқәоу хара имгакәа иҟало?
Что побуждает нас проповедовать?	ажәабжь аҳәаразы ишәымоу агәаҳәара аизырҳара?
Что помогает нам обрести смелость?	агәымшәара аизырҳара?
Что помогало служителям Иеговы оставаться верными Богу в испытаниях?	Ирыцхраауази Иегова имаҵзуҩцәа аԥышәарақәа раан иара изиашаны аанхара?
Что такое выкуп?	Изакәызеи аҿыхра?
Что такое жадность?	Изакәызеи аԥсыцәгьара?
Что такое крещение?	Изакәызеи аӡӡаахра?
 22. За что мы благодарны Иегове?	Иаҵанакуазеи ахадара апринцип?
Что такое святой дух?	Изакәызеи иԥшьоу адоуҳа?
«Что такое Царство Бога?»	«Изакәызеи Анцәа Иаҳра?»
Что ты можешь сделать:	Абар иҟауҵар улшо:
Что ты узнал об Иегове из Десяти заповедей?	Еилукаазеи уара Иегова изкны Жәа-ԥҟарак рҟынтә?
Что ценного доверил нам Иегова?	Иҳаҭәеишьазеи Иегова?
Чувствуют ли себя дети Свидетелей Иеговы обделенными из-за того, что не празднуют дни рождения?	Ак рыгрыжьуашәа рбоума Иегова ишаҳаҭцәа рхәыҷқәа, амширақәа ахьазгәарымҭо азы?
ЩИТ. Вера в Иегову и его обещания	Аԥырак ду. Иегова иқәыргәыӷрақәеи иареи рахь иааҳарԥшуа агәрахаҵара
Юноши и девушки, можете ли вы назвать Иегову своим лучшим другом?	Арԥарцәеи аҭыԥҳацәеи, Иегова сҩыза бзиа иоуп ҳәа шәызҳәома?
Юные братья, как вам завоевать доверие собрания?	Иқәыԥшу аишьцәа, иҟашәҵар шәылшозеи шәара аишьцәеи аиҳәшьцәеи шәыгәра ргаларц азы?
Я буду немедленно покидать неожиданно открывшиеся сайты эротического содержания.	Иаалырҟьаны иаатуа аеротикатә сахьақәа зну асаитқәа иаразнак иасырклоит.
Я поговорю со зрелым другом, если сорвусь и опять посмотрю порнографию.	Сыҽсызнымкылакәа апорнографиа сахәаԥшыр, доуҳала ишәу сҩыза сиацәажәоит.
«Я. твое наследство»	«Сара. иуҭынхаз соуп»
Является ли пост требованием для христиан?	Ҭахроума ақьырсианцәа рзы ачгара?

