Апанель, апплет змоу, иаркуп	Панель, содержащая апплет, заблокирована
Азеиԥш ус зегь ахәҭа, зынагӡараан апроцесс аиндикатор иадӷьалоит	Доля общего объема работы, при выполнении которой происходит приращение индикатора процесса
Асахьа аҭыԥ атекст иазхьарԥшы	Положение изображения относительно текста
Аҭаӡ иагәылоу арбара залшом	Невозможно отобразить содержимое папки
Аҭаҵа ахуҭа еиҵаӡоу агылара	Минимальная высота вложенного элемента
Аҭаҵа ахуҭа еиҵаӡоу аҭбаара	Минимальная ширина вложенного элемента
Ишьақәыргылазар, иалху амза аԥсахра ауам	Если установлено, то изменить выбранный месяц невозможно
Ҳаҭамыз, иҭацәу ахьӡ ашәырбароуп аԥштәы ҿыц азы.	Извините, но вы должны указать не пустое название для нового цвета.
Аҵәцара, афонтә сахьа ахьынтәақәҭыхтәу	Прозрачность, с которой отрисовывать фоновую картинку
Ахархәаҩ идыргақәа анонимтә рбага	Анонимный указатель на пользовательские данные
Амениу ацәаҳәа аԥхьара иазку арыд	Клавиша предназначенная для вызова строки меню
Аиҵаргыла даҽаџьара аиагара ауама	Может ли столбец быть перемещен в другое место
Арҭ рҟынтәи ҟазшьақәак аркуп	Некоторые из этих свойств заблокированы
Еиԥҟьоу аԥшь аусура мчыла ахыркәшара	Принудительно завершает работу сбоящего приложения
 Аиҭагара адгылоит алокалт фаил сиситемаҿ мацара.	Перетаскивание поддерживается только на локальных файловых системах.
Астатус ахҳәаа, ахархәаҩ ирбахо	Описание статуса, показываемое пользователю
Ари атекстзы аҵшьра астиль	Стиль подчеркивания для этого текста
Ҩ-рыдк еицрықәыӷәӷәазар, ирцәатәуп	Отключать, если две клавиши нажаты одновременно
Анапхгара ахәҭа ииаалоу аиҟаратәра	Горизонтальное выравнивание элемента управления
Иалху аелемет аартразы даҽа аԥшьык алхтәуп	Выбрать другое приложение для открытия выбранного элемента
Ари адрес аарԥшраан идырым аҩныҵҟатәи агха ҟалеит.	Произошла неизвестная внутренняя ошибка при отображении этого адреса.
Шәкомпиутер аизакыга ахәаԥшра	Просмотреть накопители вашего компьютера
Ари анимациа ахкы аднакылом	Данный тип анимации не поддерживается
Аоперациа лыԥхала изалгоума	Может ли операция успешно завершиться
Ари акаҵкәыр аиагара ҟалом.	Вы не можете переместить эту корзину.
Атекст ахархәаҩ иԥсахыр алшома	Может ли текст быть изменён пользователем
Изымуа аҵакқәа автоматла иԥсаххома иааигәаӡоу аԥхьаӡага аҵакала	Будут ли недопустимые значения автоматически заменяться на ближайшее значение счетчика
Иаҿгоу ахәҭа аиндекс ахылҵ-хәҭаҿы	Индекс дочернего элемента в элементе-родителе
Иҟоу иҭагалахо атекст еиҭаннаҵома	Перезаписывает ли вводимый текст существующий
Ишьаҭоу аҭаӡ  аиура амуит	Не удалось получить корневую папку
Афаил ахьыӡ аиҭакра амуит	Не удалось преобразовать имя файла
Иалкаау афаил ахь анеира азин еилкаашьа амам.	Права доступа для выделенного файла не могут быть определены.
Ацәаҳәа аҭагылазаашьа шԥаҭыхтәу	Как рисовать строку состояния метода ввода
Атекст авиджет ииааланы аиҟаратәра	Горизонтальное выравнивание текстового виджета
Аарта амуит, даҽа аԥшьык алхтәума?	Открыть не удалось, выбрать другое приложение?
Текстк алкааума абуфер аҿы	Выделен ли некоторый текст в буфере
Иарбатәум имаӡақәоу рыхәҭакәа	Показывать ли конфиденциальные элементы
Афаил алхтәуп адҵа . иацҵазарц	Выбрать файл для присоединения к команде.
Иаҿыгоу амениу амениҩ иацҵатәума	Следует ли добавлять отделённые меню к меню
Аԥшьқәа иҷыдоу алшарақәа ахархәара азырурома	Следует ли приложениям использовать специальные возможности
Авиджет, иаҳбац ахҵара арҭбаага ацымхәрас иаарԥшхо	Виджет, который будет отображаться вместо обычной метки расширителя
Ахы ақәыӷәӷәараан ианыруама	Чувствителен ли заголовок к нажатиям
Аԥшьы аус арураан агха ҟалеит.	Произошла ошибка при запуске приложения.
Аиагаратә пытқәыр активзар ҟалоит	Кнопка-переключатель может быть активирована
Ари ахәаԥшыга апрограмма адрес аннарԥшӡом.	Адрес не может быть отображен этой программой просмотра.
Ахәҭақәа ижәпаны рҭыԥыркра ахархәара еиҭактәуп	Переключить использование схемы плотного размещения элементов
Ианубаало ахәҭақәа реилыԥшаашьа	Порядок сортировки отображаемых элементов
Адокумент ҿыц аԥҵараан агха.	Ошибка при создании нового документа.
Адырга ииаланы аиҟаратәра	Горизонтальное выравнивание метки
Апыткәыри иаҿыгоу обиекти рҳәаа ахырҷара.	Окаймление между границами кнопки и дочерним объектом.
Ахҵара аҵакыра алкаатәума, афокус аиураан алкаа иацхраауа	Выделять ли содержимое метки, поддерживающей выделение при получении фокуса
Аҳәынаԥ ахырхага аныҟәараан хәҭақәак реицалкаара ауама	Допускать ли выделение нескольких элементов при движении указателя мыши
Аҭыхымҭа ашәагаа апанель иаҟаратәуп	Подгонять размер изображения под размер панели
Ахархәаҩтә емблема аиқәырхара ауам.	Невозможно сохранить пользовательскую эмблему.
Ари азхьарԥш хархәашьа амам, избанзар ахықәкы амам.	Эта ссылка не может быть использована, поскольку она не имеет цели.
Алокалтә сахьақәа мацароуп ахархәаҩтә дыргаҷас архәара зышәҭар ауа.	Вы можете использовать только локальные изображения в качестве пользовательских значков.
Ахқәа акәыӷәӷәара рныруеит	Заголовки чувствительны к нажатиям
Итаалоу аиҟәыҭхага аҭбаара	Ширина горизонтального разделителя
 Асервер аҽамадара ауам. Асервер ахьӡ ҭагалатәуп.	Невозможно подключится к серверу. Необходимо ввести имя сервера.
Аҵәцара анапхгара амоуп	Имеет управление прозрачностью
Иаҿыгоу ахәҭа иахьыԥшуп	Подчиняться дочернему элементу
Активра аамҭа шаҟа иадхало аԥсшьара алагаанӡа.	Продолжительность периода активности перед началом перерыва.
Акомпиутер зинда ахархәара амоурц ихьчатәуп	Защитить компьютер от несанкционированного использования
Амеиу амениуеиҵаны ианыҟало, уи ықәгылоит ииаланы инаханы	Когда меню является подменю, оно располагается со смещением по горизонтали
Аҭаӡахь аиасра залшом, избанзар иара илокалтәуп	Невозможно перейти в папку, так как она не является локальной
Амаругақәа арпанель амкуазар, иарбалатәума ахыц	Показывать ли стрелку, если панель инструментов не помещается
Ахы азы агәынкылара аизшара залшом	Невозможно распределить память для заголовка
Ааиӷәа ихархәаз аарттәуп	Отрыть недавно использовавшиеся
Афаил алхраз адиалог ахы	Заголовок диалога выбора файлов
Ишьакәыргылоуп, акьыԥхьра апроцесс еицыҟамлозар.	Установлено, если процесс печати может происходить асинхронно.
Ԥхьаҟа иазго апытҟәыр цхыраагӡа	Дополнительная кнопка перемещения вперёд
Ари аелемент ахьӡ ԥсахра ҟалом.	Этот элемент не может быть переименован.
Автоматла ирзеиԥшу иаԥсахуам	Подставляется ли автоматически общий
Ари атег аҵәаӷәара ианыруама	Влияет ли этот тег на перечёркивание
Ахархәаҩтә дыргаҷа ашьақәыргыларазы, сахьакь мацара еиҭажәг.	Перетащите только одно изображение, чтобы установить пользовательский значок.
Ирыбжьоу, аиагареи-акажьреи апроцесс алагаанӡа	Расстояние, прежде чем процесс перенести-и-бросить начнётся
Авиджет анҭыҵ ахәаақәа рҵакыра асахьазы	Размер областей за пределами виджета для отрисовки
Ари атег ашрифт ылгара ианыруама	Влияет ли этот тэг на насыщенность шрифта
Иҭацәу аҭыԥ аԥшаара амуит	Не удаётся найти свободное место
Афаил алхраз адиалог ахы.	Заголовок диалога выбора файлов.
Иҷыдоу алшарақәа аҿактәуп	Включить специальные возможности
Аԥшь алхтәуп иара ахәәаа ахәаԥшразы.	Выбрать приложение для просмотра его описания.
Секундк шаҟа пиксель артәои амаксималтә ццакыра	Сколько пикселей в секунду составляет максимальноая скорость
Алакалтә фальқәа мацароума иалххо	Будут ли выбранные файлы только локальными
Ииаалау аиҭагага цәаҳәа анубаалартә ианыҟало	Когда будет отображаться горизонтальная полоса прокрутки
Анапхгара ахәҭа афокус аиуратә иҟоума	Является ли элемент управления получающим фокус
Ашәарҭадара иахырҟьаны ари ҿыхәуп.	Это отключено по соображениям безопасности.
Аҭаӡ иара ахаҭахьы ақәҭыхра ҟалом.	Вы не можете скопировать папку саму в себя.
Аҭаӡ ахаҭа иара ахь аиагара ҟалом.	Вы не можете переместить папку саму в себя.
Ихыло аҵаҳәарақәа ахәҭақәа зегь рзы арбара	Показывать для каждого элемента всплывающую подсказку
Асахьазы адыррақәа рҭагалараан агха ҟалеит	Произошёл сбой при загрузке информации об изображении
Ахалагаратә шрифт ахьыӡ	Наименование исходного шрифта
Имнемотикау иласу арыд ари ахҵаразы	Мнемоническая быстрая клавиша для этой метки
Аиҿкаага иаҿгоу авиджет иазхьарԥшы аҭыԥ	Позиция регулятора относительно дочернего виджета
Ахсаала агәаҭара авиджет иаҵанакру иазшоу ақәыԥшылара зегьы	Будет ли виджет просмотра образца занимать всё отведенное ему пространство
Ари ацаԥха шьақәыргылазар, апанель азин анаҭом аԥшь мчыла аркра. Иашьашәалоу апытҟәыр ахь анеира ҟалом.	Если этот ключ установлен, панель не будет позволять принудительно завершать приложение. Соответствующая кнопка будет недоступна.
Адиалог алкаара аҵәцара 	Прозрачность диалога выделения
Аинтерфеис еидкылоу аилкаара	Объединённое определение интерфейса
Игәҵәыланы ианыҟоу иубарҭоуп	Видим при вертикальном расположении
Аҭаҵа акомпакт-диск иҭаҩтәуп	Записать содержимое на компакт-диск
Иаҿгоу авиджет ииааланы апозициа	Позиция дочернего виджета по горизонтали
Анапхгара ахәҭа ҵҩанҵәыла аиҟаратәра	Вертикальное выравнивание элемента управления
Ииааланы аиҟаратәра иаҿыгоу ахәҭақәа рзы	Горизонтальное выравнивание для дочерних элементов
Анахага апытҟәыркәеи  арбагеи  ирыбжьаӡо	Расстояние между кнопками перемещения и указателем
Авиджет ахҵара ахәҭа ҳасабла  ахархәараз	Виджет для использования в качестве метки элемента
Аҭаӡ азкра ахыҵхырҭа аҭаӡ аҩныҵҟа иҟоуп.	Папка назначения находится внутри папки источника.
Ари асеанс иалгатәуп, даҽа хархәаҩк ихьӡала анеиразы	Завершить этот сеанс, чтобы войти под именем другого пользователя
Ацәаҳәа аеллиптизациаан иалху аҭыԥ, аус шцо аиндикатор иамамзар иақәнаго аҭыԥацәаҳәа зегь анубааларц азы	Предпочтительное место для эллиптизации строки, если индикатор хода процесса не имеет достаточно места для отображения всей строки
Аԥшьы иацхраауа авиджет афаил ақәыԥшыӷақәа рарбаразы.	Поддерживаемый приложением виджет для отображения образцов файлов.
Арадио-пытҟәыр, агәыԥахь ари апытҟәыр зҵазкуа	Радио-кнопка, к группе которой принадлежит данная кнопка
Ииагаз атекат изуа афаил адресны иҟамызт.	Перенесённый текст не был допустимым адресом файла.
Адыргаҷақәа, иахеиҭагаз иааныжьлатәуп	Оставлять значки там, куда они были перетащены
Амениу аҭаҵахьы даҽа мҩак алхтәуп	Использовать иной путь к содержимому меню
Аилыркаага аарԥшраан агха ҟалеит.	При отображении справки произошла ошибка.
Ишьақәыргылазар, адыргаҿ аҵшьра иаанагоит, иааиуа асимвол арыдқәаеилаҵаноуп ишхархәагатәхо.	Если установлено, подчёркивание в метке означает, что следующий символ должен использоваться в комбинации клавиш.
Ахарахәараҩтә интерфеис ахҭыс	События пользовательского интерфейса
Адыргаҷақәа шьҭахьла раарԥшра	Показывать значки в обратном порядке
Аишәа рацқьаразы апытҟәыр	Кнопка расчистки рабочего стола
Ацәаҳәалдагаҿ адырга аҭыԥ	Расположение отметки на линейке
Аладио-ҟаҵара, ари агәыԥ ахь зҟаҵара аҵанакуа.	Радио-действие, группе которого принадлежит это действие.
Афабрика аԥенџьырқәа рыбжьара анавигациазы	Фабрика для создания апплетов навигации между окнами
Уажәааигәа ихархәаз ахәҭақәа рнапхгара	Управление недавно использовавшимися элементами
Ишьақәыргылаӡам, апринтер илабҿабоу маҭахәны иҟазар	Не установлено, если принтер представляет реальное оборудование
Амаругақәа рпанель ахәҭа ииаланы ианыҟо иубаратәы иҟалоумаамаругақәа рпанель.	Будет ли элемент панели инструментов видим при горизонтальном расположении панели инструментов.
Иаанхаз ахәҭа аиқәырхара амуит	Не удалось сохранить оставшуюся часть
Ҳаҭамыз, аха иарбатәуп иҭацәым ихадоу ажәа аемблема ҿыц азы.	Извините, но необходимо указать непустое ключевое слово для новой эмблемы.
Ари ацаԥха шьақәыргылазар, усҟан  аәҿынаԥ апанель ианақәкым апанель иаразнак аекран акәакьахь аҽаҵәахуеит. Аҳәынаԥ арбага ари акәакь ахь ианиаслакь апанель аатуеит.	Если этот ключ установлен, то при покидании указателем мыши пространства над панелью панель автоматически скрывается в угол экрана.  Перемещение указателя мыши в этот угол вызовет раскрытие этой панели.
Инахароу асервер аҽамадара	Подключение к удаленному серверу
 Афонтә ҭыхымҭа аԥкаарақәа	Подробности фонового изображения
Изныԥшо афаил ахкы алхтәуп	Выбрать отображаемые типы файлов
Аҵакыра, ардырра адыргаҷақәа ахьцәырҵуа	Область, в которой появляются значки уведомления
Ахҵара атекст ахәынаԥ ала алкаара ауама	Может ли текст метки быть выделен с помощью мыши
Алкаара наҟтәи аҵыхәа аҭыԥ ахырхага аҟынтәи символны	Положение противоположного конца выделения от курсора в символах
Аԥшьы иацхраауа авиджет ихарҭәаау аопциақәа рзы.	Поддерживаемый приложением виджет для дополнительных опций.
Иаарту арҭбаага аԥшаара залшома иаҿыгоу ахәҭақәа	Может ли открытый расширитель обнаруживать дочерний элемент
Ахәҭа аҳәаа анубаалартә иҟалома	Будет ли отображаться граница элемента
Азин ыҟоума арыдыркра аанкылара	Разрешается ли блокирование клавиатуры
Аҭаӡ ахәҭа ахәаԥшра ишыҟоу еиԥш	Компонент просмотра папок по умолчанию
Ари адрес иадҳәалоу, ишыҟаз еиԥш аҟаҵазаара ыҟам.	Отсутствует действие по умолчанию, связанная с этим адресом.
Асахьа аҭагаларазы агәынкылара азхом	Недостаточно памяти для загрузки изображения
Аартра амуит, даҽа ҟаҵарак алхтәума?	Открыть не удалось, выбрать другое действие?
Аҭаҵа ахәҭақәа зегьы рыҽдырҭбаауама изхылҵыз ахәҭа ашәагаа анеицыҵуа	Расширяются ли все вложенные элементы при увеличении размера родительского элемента
Ариа афаилтә еилазаара аҿаԥшьра аднакылом	Эта файловая система не поддерживает подсоединение
Аҭагалара шиашо гәаҭаны ҽазнык шәҽазышәа.	Проверьте правильность ввода и попробуйте еще раз.
Аиҵаргыла ахы аҟны атекст аиҟаратәра ма анапхгара ахәҭа ииааланы	Выравнивание текста или элемента управления в заголовке столбца по горизонтали
Аҭаӡ ҿыц аԥҵараан агха.	Ошибка создания новой папки.
Кәаԥла иҟаҵоу асахьа, аҭыӡҭеиԥш ахархәара зауа атекст аԥхьатәи аплан асахьааҭыхраан	Точечный рисунок, который будет использоваться в качестве маски при прорисовке переднего плана текста
Иҷыдоу алшара змоу аԥшьы аҭалараан аусура иаларгахо	Запускаемые при входе приложения со специальными возможностями
Шәара шәаԥшәымаӡам, убри аҟынтә арҭ азинқәа шәзыԥсахӡом.	Вы не являетесь владельцем, поэтому вы не можете изменить эти права.
Иҟам аҭагалара инарҭбаау аиҿыртәа	Расширенные устройства ввода отсутствуют
Акьамам цәаҳәак арежим аҿы иҟоума	Находится ли ярлык в режиме одной строки
Фаилқәак иаразнак ралкаара ҟалома	Допускать ли выделение нескольких файлов
Акаталогқәа еснагь  ахҳәааҟаҵагаҿ	Всегда открывать каталоги в обозревателе
Шәақәыӷәӷәа, мызктәи амзар шәахәаԥшырц	Щелкните, чтобы просмотреть календарь на месяц
Апанель аус аруп. Апанель ҿыц аус арухаӡом.	Панель уже запущена. Новая панель запущена не будет.
Иццаку арыд аԥсахра аҭакԥхыкәра зду авиджет	Виджет который отвечает за изменение быстрой клавиши
Адҵа анагӡаразы адыргаҷа	Значок команды для выполнения
Хыхьтәи агәҭатәи апанель	Верхняя центрированная панель
Иалшәо аиндикатор ашәага	Размер выпадающего индикатора
Асахьа аҭагаларазы агәынкылара азхом; шәҽазышәшәа иашәыркырцаԥшьқәа, агәынкылара ҭашәырцәырц	Недостаточно памяти для загрузки изображения; попытайтесь закрыть некоторые приложения, чтобы освободить память
Параметрқәак адиалог аҟны иааибуом	Некоторые параметры в диалоге конфликтуют
Ахәҭақәа реицлкаара азин ҟаҵатәума	Позволять ли выделять несколько элементов
Ианышьақәыргылоу, аиҭаҵрақәа рыхҭысқәа ардырра ари аекран ахәҭақәа рахь инеиӡом	Когда установлено, события уведомления о перемещении не доставляются для элементов этого экрана
Иласу арыд  аппараттә код	Аппаратный код быстрой клавиши
Ацәаҳәақәа аҵлаҿы ианубаалоума	Будут ли отображаться линии в дереве
Иалшәо ахәҭа ахархәара залмыршахеит	Не удаётся использовать выпадающий элемент
Ицифратәым асимволқәа гәықәҭажьхома	Будут ли игнорироваться нецифровые символы
Ажәабақәуа рхыԥхьаӡара, аҵаказы ианыԥшуа	Число десятичных цифр, отображаемых для значения
Уажәтәи адокумент аҟны аорфографиатә ҽгәаҭара	Автоматически проверять орфографию в текущем документе
Ацаԥха иминималу аура аиқәшәаракәа рыԥшаараан	Минимальная длина ключа в порядке поиска на совпадение
Амеиу амениуеиҵаны ианыҟало, уи ықәгылоит ҵәҩанцәыла инаханы	Когда меню является подменю, оно располагается со смещением по вертикали
Аԥхьаӡага ашкала аегьи аҵыхәахь иасуама  аҵакыра аҳәаа анхартәаахалагь	Будет ли счетчик переходить к другому концу шкалы при достижении предельных значений
 Илшома ахархәаҩ динамикала арццакыга аҭагалара ҿыц иактиву аекран мениу ақәкраан	Может ли пользователь динамически вводить новый ускоритель при наведении на активный элемент меню
Ахы, аԥенџьырқәа рдиспечераҿ ианубаало абри амениу азы аҟәыгара ашьҭахь	Заголовок, который диспетчер окон будет отображать для этого меню после его отделения
Ари адрес аарԥшразы аусурҭа аишәа алаԥшхгара архәара аҭатәуп.	Использовать просмотр в виде рабочего стола для отображения этого адреса.
Ииаало аҳәаа аҭбаара агәылаҵа ахҵара	Ширина горизонтальной границы меток вкладки
Ари аҭаӡаҿ иҭацәу афаил ҿыц аԥҵатәуп	Создать новый пустой файл внутри этой папки
Аҭаҵа инормоу ашәагаа ала иаарԥштәуп	Отобразить содержимое с нормальным размером
Аусурҭа еишәа афон ҭыхтәуп	Отрисовывать фон рабочего стола
Аҵыхәтәан инагӡаз адҵа ала алкаа гәаҭатәуп	Просмотреть вывод от последней выполненной команды
Апанель ахәҭақәа реиҿкааразы аиҟәшага	Разделитель для организации элементов панели
Ахҵареи адыргаҷеи ирыбжьаӡо пиксельла	Расстояние в пикселях между значком и меткой
Ари атег атекст арбара ианыруама	Влияет ли этот тег на видимость текста
Иаҿыгоу авиджет гәҵәыла апозициа	Позиция дочернего виджета по вертикали
Ари аԥшьазы узыԥхьартә иҟоу ахьӡ	Читаемое название для этого приложения
Иабантәи ааи ари аԥсыӡ гаӡа	Откуда приплыла эта глупая рыбка
Асахь аҭбаара ноль иаҟароуп	Изображение имеет нулевую ширину
Адаҟьа ашьашәалараз аиԥшьра	Приращение для страницы подгонки
Иаҿакума иаразнактәи аныхра	Включено ли немедленное удаление
Ишьақәыргылазар, аиҭагага анҵәамҭа ахәҭақәа аҩганк рҿы иубарҭахоит еиԥшымкәа	Если установлено, детали окончаний на обоих сторонах прокрутки будут рисоваться по-разному
Иалышәх аиҿкаара, аинформациа адыргаҷақәа рыҵаҟа цәырҵлартә еиԥш. Амасштаб аиёәатәраан еиҳа аинформациа цәырҵлоит.	Выберите порядок, в котором информация будет возникать под именами значков. При увеличении масштаба будет появляться больше информации.
Апрограмма сахьала аиқәыршәара иалахәыз рыхьӡынҵа	Список участвовавших в художественном оформлении программы
Аҭаацәаратә виджет ари авиджет азы. Иконтеинеру-виджетзароуп	Родительский виджет для этого виджета. Должен быть виджетом-контейнером
Анаҩс шәызҭааз адрес ахь ииастәуп	Перейти к следующему посещенному адресу
Изхылҵыз аԥенџьыр ақәгараан ари аԥенџьыр ықәгахома	Уничтожается ли это окно при уничтожении родительского окна
Иҟоу афаилқәа иеиҭанҵалатәуп	Перезаписывать существующие файлы
Иццаку арыд авиджет анпхгара	Виджет управления быстрой клавиши
Ахәҭақәа максимумла реиҵыхра	Максимальное расширение элементов
Адыргаҿ ихархәатәума иалху ашәагаа	Использовать ли в метке выбранный размер
Ишьақәыргылазар, атекстҿ аҵшьра иаанагоит, иааиуа асимвол ахархәара амоуп арыдқәа реилаҵаҿ.	Если установлено, подчёркивание в тексте обозначает, что следующий символ используется в комбинации клавиш.
Ишьақәыргылазар, иалшәо аԥенџьыр анубаалоит цәахәак аҟны.	Если установлено, выпадающее окно будет отображаться одной строкой.
Ахышәарақәа, ииаалоу иаҿыгоу ахәҭақәа рхымҩаԥгашьа узырбо	Параметры, определяющие горизонтальное поведение дочернего элемента
Исериалтәқәоу  адыррақәа иашаны иеиҿкаам	Сериализованные данные неправильно сформированы
Иаднакылома иҭагалоу асимвол атабулиациа	Будет ли приниматься введённый символ табуляции
Аусура еишәаҿы иаԥшьу атомқәа арбалатәуп	Показывать подсоединённые тома на рабочем столе
Ихыло амениу арбалатәуп	Показывать всплывающее меню
Ари асервер аҽамадатәуп	Соединиться с этим сервером
Ацҵаразы аԥштәы алхтәуп	Выбрать цвет для добавления
Агылаҵа азы ахҵара, ицхыраагӡоу ахәҭақәа змоу.	Метка для вкладки, содержащей дополнительные элементы.
Азкра аҭыԥ аҿы анҵаразы иақәнагоу азин шәымам.	У вас не достаточно прав на записи в место назначения.
Хыхьтәи ирҭбаау агантә панель	Верхняя расширенная краевая панель
Акаҭа аиҵаргылақәа рыбжьаӡара	Пространство между столбцами сетки
Афаил иара ахаҭахьы ақәҭыхра ҟалом.	Вы не можете скопировать файл сам в себя.
Пиксельла ирыбжьоу, арбага аиагара ахьахәҭоу, аҳәынаԥ аныҟәара аццакра аласра активтәра азухаанӡа. 1-тәи аҵакы системаны иҟоупишыҟоу еиԥш аҵакала.	Расстояние в пикселях, на которое надо передвинуть указатель, прежде чем будет активировано ускорение движения мыши. Значение -1 является системным значением по умолчанию.
Еилкаам афона ахкы ҳауит	Получен неизвестный тип фона
Изымуа аԥштәы адыррақәа аиуит 	Получены недопустимые данные цвета 
Иҟоума иҭаргало адыррақәа ахьӡынҵаҿы	Присутствуют ли вводимые значения в списке
Ахархәаҩ еиҭеигар ҟалома агәылаҵакәа	Может ли пользователь переставлять вкладки
Ахархәаҩ амениу ацрыхны аекран аҟны аиагареи дақәиҭума	Может ли пользователь отцеплять меню и передвигать их по экрану
Шәара шәыхьӡынҵаҿы иҟам адресқәа ргәылаҵа анышәхыр шәҭахума?	Хотите удалить все закладки на несуществующие адреса из вашего списка?
Ари ацаԥха шьақәыргылазар, арбага асааҭ апплет ианақәку арыцхә аныԥшуеит.	Если этот ключ установлен, при наведении указателя на апплет часов отображается дата.
Аиҿкаашьа алышәх, аинформациа ари аҭаӡ аҟны иаарԥшхартә еиԥш.	Выберите порядок, в котором информация будет отображаться в этой папке.
Иалнаршома аԥштәы алхра адиалог аҵәцара анапхгара	Позволяет ли диалог выбора цвета управление прозрачностью
Аҟазшьақәа рдиалог аарԥшра ауам	Не удаётся отобразить диалог свойств
Аус арура адиалог аарԥшра амуит	Не удаётся отобразить диалог запуска
Асааҭ апплет аԥҵаразы афабрика.	Фабрика для создания апплетов часов.
Афаил анҵәамҭа изаацәан иԥшаауп	Преждевременно обнаружен конец файла
Ахыц аиҭагага акәша-мыкәша аҭыԥ	Пространство около стрелки прокрутки
Аусурҭа аиагарҭа аҟнытә аҵәахра	Скрыть из переключателя рабочих мест
Иццаку арыд аус адулага аԥсахга	Обработчик изменения быстрой клавиши
Аҵла аартра ахәҭақәа арбалатәуп	Показывать элементы раскрытия дерева
Акселлераторқәа рыԥсахра алшара	Возможность изменения акселлераторов
Асерве абжьы ахархәара аҿактәуп	Включить использование сервера звука
Аекран аанкылара аҿыхтәуп	Отключить блокирование экрана
Ахыц ҵәҩанцәыла аҩаскьара	Вертикальное смещение стрелки
Ардырра апанель ахырхарҭа	Ориентация панели уведомлений
Аҩада аҩахара анырралшара	Чувствительность сдвига вверх
Иарбатәума ахәҭақәа, уахьзымнаӡо аресурсқәа узырбо	Показывать ли элементы, указывающие на недоступные ресурсы
Аҩбатәи апытҟәыр ахыц аԥхьҟа ирханы иаҿаԥшуа аган ацәаҳәа аиҭагагаианубаало	Отображать вторую кнопку со стрелкой вперёд на противоположной стороне полосы прокрутки
Асервер абжьы ахархәара аҿыхтәуп	Отключить использование сервера звука
Шәара ишәылшоит даҽа программак алхра ма даҽа адреск ахь аиасра.	Вы можете выбрать другую программу просмотра или перейти к другому адресу.
Аҭаӡ аԥҵара ауам, избанзар ари еиԥш ахьыӡ змоу афаил ыҟоуп.Аҭаӡ даҽа хьӡык азышәыԥшаа, ма афаил ахьаӡ шәыԥсах.	Папка не может быть создана, так как файл с таким именем уже существует.  Выберите другое имя для папки, или переименуйте файл.
Ихыло аҵаҳәарақәа аҿактәуп	Включить всплывающие подсказки
Аԥштәы алхраз аидиалог ахы	Заголовок диалога выбора цвета
Ари атег анахара ианыруама	Влияет ли этот тег на смещение
Абраузер ишыҟоу еиԥш иаҭахума атерминал	Нуждается ли браузер по умолчанию в терминале
Аԥкаара аҩаӡара ишыҟоу еиԥш иарбалатәуп	Показывать с уровнем детализации по умолчанию
Иунарбоит иӡысо аԥсыӡ мамзаргьы анимациа зызу даҽакы	Отображает плавающую рыбку или другое анимированное создание
Атексти адыргаҷақәагьы хәҭацыԥхьаӡа дара-дара позициала ишеизыҟоу	Как текст и значки каждого элемента позиционируются относительно друг друга
Аштрихқәа рҿырԥшы-индикатор арбаразы аҭагалара афокус	Образец штрихов для отображения линии-индикатора фокуса ввода
Хыхьтәи аҩаӡара апанель аидентификатор, ари аобиект згәылоу.	Идентификатор панели верхнего уровня, которая содержит данный объект.
Аилыԥшаара ахырхарҭа аиндикатор ианубаалозароуп	Направление сортировки должно отображаться индикатором
Агәылаҵа иаҿаԥшуа аганаҿ ианыԥшроуп аҩбатәи апытҟәыр ахыц ԥхьаҟа ахы рханы	Отображать вторую кнопку со стрелкой вперёд на противоположной стороне полосы вкладок
Ашрифт алгара шьақәыргылоуп	Насыщенность шрифта установлена
Иактивума аиҭагага-апытҟәыр	Активна ли кнопка-переключатель
Адиало цҳамҭа ихадоу атекст	Главный текст диалога сообщения
Ижәпаны аҭыԥыркра ахархәара	Использовать плотное размещение
Ахҵараҿы ихархәатәума иалху ашрифт	Использовать ли в метке выбранный шрифт
Аҩнытәи акаталог адыргаҷа аусуратә еишәаҿы иҟоуп	Значок домашнего каталога присутствует на рабочем столе
Аеламент аԥышәхыр, уи рхынҳәышьа амамкәа иӡуеит.	Если вы удалите элемент, он будет безвозвратно утрачен.
Асахьа агылара ноль иаҟароуп	Изображение имеет нулевую высоту
Асахьа апиксельтә дыррақәа ԥхасҭоуп	Пиксельные данные изображения повреждены
Иҭацәу аҵакы абри аҭыԥаҿ аҭагалара залшома	Может ли пустое значение быть введено в это поле
Иактивызтәуа аҵакыра азгәаҭоуп асахьа аҳәаа анҭыҵ	Активирующая область определена за границами изображения
Иҳәазо ашәагаа ԥсахтәӡам, баша иаҭатәуп иара ашәагаа хуҷы	Не изменять размер ползунка, просто задать ему минимальный размер
Асистематә терминал шрифт хархәатәуп	Использовать системный терминальный шрифт
Абларҭаҿы ахәҭақәа зланыԥшуа амодель	Модель для отображения элементов в ячейке
Шаҟа миллисекунд иазыԥштәузеи, аҳәынаԥ рныҟәара арыдқәа иалагаанӡааусура	Сколько миллисекунд одидать, прежде чем клавиши передвиджения мыши начнут работать
Ахархуәаҩ ихы иаиырхәо арбара	Показать руководство пользователя
Амениу аелемент анагӡара ауам	Не удаётся выполнить элемент меню
Амениуеиҵа ааиаанӡа аанкылара	Задержка перед появлением подменю
Ахәҭа ашәага хыхьи ҵаҟеи рыла ардура аҩаӡара	Степень увеличения размера элемента сверху и снизу
Апрограмма алхтәуп иалкаау адокумет аартразы	Выбрать программу для открытия выбранного элемента
Апытҟәыр иақәыӷәгӷәаны ианыҟоу аиҭага аҵакы арццакра	Ускорение прокрутки значений при удерживании нажатой кнопки
Ашрифт амасштабркра акоефицент	Коэффициент масштабирования шрифта
Иласу арыд амодификатор аҭыӡҭа	Маска модификатора быстрой клавиши
Асахьақәа амениу аҿы иунарбома	Показываются ли в меню изображения
Напыла аҭыԥ арбара ииагатәума?	Переключить на размещение вручную?
Илакаау дыргаҷацыԥхьаӡа аханатә изаҟараз еиԥш ашьақәыргылара	Восстановить каждый выделенный значок до его первоначального размера
Аҳа ацәаҳәа знубаало аштрихқәа аҿырԥшы	Образец штрихов для отображения линии сетки
Акаҵкәыр ахь еиҭамгакәа аҭаӡ аԥаыхтәуп	Удалить эту папку без перемещения в корзину
Изырҭбаауа ахыц ашәагаа	Размер расширяющей стрелки
Ҵәҩанҵәылатәи ахыц аура	Длина вертикальной стрелки
Ҽазнык ихҩаалатәума иҟоу акеш, иара рҿыцзаргьы	Перезаписать существующий кеш, даже если он обновлён
Ахархәаҩ мыругақәа рпанели  ацрыхны урҭ аекран аҟны аиагара дақәиҭума	Может ли пользователь отцеплять панели инструментов и передвигать их по экрану
Ари ацаԥха шьақәыргылазар, усҟан афонтә ҭыхымҭа иааҳәны иҟалоит, апанель ҵәҩанҵәыла ирхиазар.	Если этот ключ установлен, то фоновое изображение будет повёрнуто, если панель ориентирована вертикально.
Ари атекст азы  ахархәаҩ итабулиаторқәа	Пользовательские табуляторы для этого текста
Ари ацаԥха шьақәыргылазар, анимациа ҵәҩанҵәылатәи апанельқәа рҿы иаарҳәны иубарҭахоит.	Если этот ключ установлен, на вертикальных панелях анимация будет отображаться в повёрнутом виде.
Иалкаауцыԥхьаӡа аелемет алаԥшхгара ма аҟазшьа ааиҭакра 	Просмотреть или изменить свойства каждого выделенного элемента
Аелиптра ацәаҳәа иахьанаало аҭыԥ, ацәаҳәа аарԥшра амеханизм абларҭқәҿы аҭыԥ азымхозар ацәаҳәа зегьы аарԥшразы.	Желаемое место эллиптизации строки, если механизму отображения строки в ячейке не хватает места для отображения всей строки.
Иалкаау афаил Алаԥшхгара	Просмотреть выделенный файл
Адыргаҷа атагалара амуит	Не удаётся загрузить значок
Идыру аԥшьқәа рыхьӡынҵа 	Список известных приложений
Ахыкәласрала афокус акра	Захватывать фокус по щелчку
Уажәтәи иалху афаил ахьӡ	Текущее выбранное имя файла
Хәҭацыԥхьаӡа азы авиджет	Виджет для каждого элемента
Минималла изуа аиҵаргыла аҭбаара	Минимально допустимая ширина столбца
Иаарту аҭаӡ акаҵкәырахь аиҭагара	Переместить открытую папку в корзину
Даҽа ҟаҵарақәак ари афаил алаԥшхгаразы ыҟам.  Амала ари афаил шәкомпиутер ахь акопи азыҟашәҵар, аартра шәылшоит.	Другие действия для просмотра этого файла недоступны.  Если вы скопируете этот файл на свой компьютер, вы сможете открыть его.
Ахҵараҿы иарбалатәума иалху ашрифт астиль	Показывать ли в метке размер выбранного шрифта
Афаилқәа раарԥшразы аминиатиура арбатәума	Показывать ли миниатюры для файлов изображений
Асахьа зтәу афаил аформат еилкаам	Формат файла изображения не распознан
Максималла изуа аиҵрагыла аҭбаара	Максимально допустимая ширина столбца
Ари атег ашрифт араӷара ианыруома	Влияет ли этот тэг на разрядку шрифта
Ахцъажъаратъ хьыӡқәа ҭажәгал емблемацыԥхьазы. Уи ахархәара аиоуеит анаҩс аемблема аидентификациазы.	Введите описательное имя для каждой эмблемы. Это имя будет использовано впоследствии для идентификации эмблемы.
Аҩнытә каталог ахь аиасра	Перейти к домашнему каталогу
Ҵаҟатәи агәҭантәи апанель	Нижняя центрированная панель
Алада алахара анырралшара	Чувствительность сдвига вниз
Агәҵәылатәи амасштабыркра	Вертикальное масштабирование
Абжьытә фаиқәа рзыӡырҩра:	Прослушивать звуковые файлы:
Амыругақәа ихадоу рпанель	Основная панель инструментов
Уажәтәи аҵакы иаԥхьо ма иҿыцны ишьақәныргыло аҵакы	Читает текущее значение или устанавливает новое значение
 Иалышәх аиҿкаара, аинформациа адыргаҷақәа рыҵаҟа цәырҵлартә еиԥш. 	Выберите порядок, в котором информация будет возникать под именами значков.
Аиҵаргыла ашәагаа ахархәаҩ иԥсахырц илшоит	Размер столбца может быть изменён пользователем
Аԥшьы ишиашоу авиджет аҟны асахьа аннаҵома	Будет ли приложение рисовать напрямую в виджете
Ишьақәыргылазар, авиджет иаиуеит аҟаҵара ишыҟоу еиԥш афокус аҭагаларааиураан	Если установлено, то виджет получает действие по умолчанию при получении фокуса ввода
Аиларкаага адокумент аарԥшра амуит	Не удаётся отобразить документ справки
Аемблема ҿыц азы аҭыхымҭа алхтәуп:	Выбрать изображение для новой эмблемы:
Ишьақәыргылазар, усҟан иаҿыгоу ахәҭа аҭаацәаратә шәагаагьы аԥсахуеит	Если установлено, то дочерний элемент изменяет размеры вместе с родительским
Уажәтәи араӡага ианубаало ахәҭақәа ралхразы	Текущий фильтр для выбора отображаемых элементов
Агәҵәылатәи аиҟаратәра иаҿыгоу ахәҭақәа рзы	Вертикальное выравнивание для дочерних элементов
Адгылара змам аиҭагара атип ахархәара аман.	Был использован недопустимый тип перетаскивания.
Иаарту аҭаӡ алаԥшхгара ма аҟазшьа ааиҭакра 	Просмотреть или изменить свойства открытой папки
Ари адрес иадҳәаланы, аҟаҵазаара ишыҟоу еиԥш аус арураан агха ҟалеит.	Произошла ошибка при запуске действия по умолчанию, связанной с этим адресом.
Ишьақәыргылазар, аблокнот аҵакыра аҟны аҳәынаԥ арӷьарахтәи арыд ақәыӷәӷәараан иааиуеит ихыло амениу, адаҟьақәа рҿы аиҭагаразы ухы иауырхәо	Если установлено, то при нажатии правой клавиши мыши в области блокнота появится всплывающее меню, которое можно использовать для перемещения по страницам
Аартра ахәҭақәа арбалатәуп	Показывать элементы раскрытия
Адаҟьа шеибгоу ихархәатәуп	Использовать страницу целиком
Уажәтәи архив ҽахьӡык ала ахьчатәуп	Сохранить текущий архив с другим именем
Адыргаҷ аҭагалазы агәынкылара азхом	Недостаточно памяти для загрузки значка
Аекран, аԥенџьыр знубаалартә иҟало 	Экран, на котором будет отображено окно
Ари аҭаӡаҿ иҭацәу аҭаӡ ҿыц аԥҵатәуп	Создать новую пустую папку в этой папке
Ари ацаԥха шьақәыргылазар, апанель аԥыхраан адҵа ашьақҿырӷәӷәаразы ишәыдҵаалоит.	Если этот ключ установлен, при попытке удаления панели будет запрашиваться подтверждение.
Аԥштәы ашьақәыргылара ауам.	Цвет не может быть установлен.
Ахәҭа ашәага армеи арӷьеи рыла ардура аҩаӡара	Степень увеличения размера элемента слева и справа
Ахҭыс анааиуа аамҭаз абыжьқәа рыҭара аҭахума.	Следует ли подавать звуки при наступлении событий.
Ари афаил алаԥшхгаразы даҽа ҟаҵарак ыҟам. Амала ари афаил шәкомпиутер ахь акопи азыҟашәҵар, аартра шәылшоит.	Нет других приложений для просмотра этого файла.  Если вы скопируете этот файл на ваш компьютер, вы сможете открыть его.
Абзацаҿ иагоу ацәаҳәақәа рыбжьара ақәыԥшылара пиксельла	Пикселей в пространстве между перенесёнными строками в абзаце
Иалкаау елементцыԥхьаӡазы асимволикатә зхьарԥш аԥҵатәуп	Создать символическую ссылку для каждого выделенного элемента
Акаҵкәыр шәрыцқьар, уа иҭоу ахәҭақәа зегьы ишәызмырхынҳәуа ианыххоит.Ижәдыруаз, дара анышәхыр шшәылшо акакала.	Если вы очистите корзину, все элементы в ней будут удалены окончательно. Учтите, что вы можете также удалить их по одному.
Аекран аҿы адиапазон аҽаԥсахлар шԥаку	Как диапазон должен обновляться на экране
Рыҽдырҭбаауама иаҿыгоу ахәҭа агәылаҵа	Расширяются ли вкладки дочернего элемента
Иалкаау адыргаҷақәа еиҵыҵуа иҟаҵатәуп	Делать выделенные значки растягивающимися
Узқәымгәыӷӡо акадрқәа реишьҭагылара аартуп анимациа аҟны	Непредвиденная последовательность кадров обнаружена в анимации
Ақәыԥшылара ацхыраагӡа, амениу иацҵахо армеи арӷьеи рыла	Дополнительное пространство, добавляемое к меню справа и слева
Иҟаҵатәуи инагӡатәу атекст фаилқәа урҭ активациа рзураан	Что делать с исполнимыми текстовыми файлами при их активизации
Аҟаҵазаара ишыҟаз еиԥш ари аԥкаанҵа иацхраауам.	Действие по умолчанию не поддержтвает этот протокол.
Ахәҭа ԥшаатәуп, апанель: ахь иацҵазарц	Найдите элемент, чтобы добавить на панель:
Агәылаҵа иаҿаԥшуа аганаҿ ианыԥшроуп аҩбатәи апытҟәыр ахыц шьҭахьҟа ахы рханы	Отображать вторую кнопку со стрелкой назад на противоположной стороне полосы вкладок
Ииааланы шаҟа еиҭагатәузеи иаҿыгоу ахәҭа, апытҟәыр иагәҭасны иҟазар	На сколько переместить дочерний элемент по горизонтали, если нажата кнопка
Адҵа, ахыкәласрала имҩаԥырго:	Команда, выполняемая при щелчке:
Иалкаау аелемент ахьӡ аԥсахра	Переименовать выделенный элемент
Акаҵкәыр аҟны ахәҭақәа рақәҭыхра ҟалом.	Вы не можете копировать элементы в корзину.
Аҩбатәи апытҟәыр ахыц ашьҭахьҟа ирханы иаҿаԥшуа аган ацәаҳәа аиҭагагаианубаало	Отображать вторую кнопку со стрелкой назад на противоположной стороне полосы прокрутки
Иҩбатәу атекст ацҳамҭа адиалог	Вторичный текст диалога сообщения
Иҭыҵа акәалаԥ егьырҭ ахәҭақәа рыҵәахразы	Выдвижной ящик для хранения других элементов
Атекст авиджет иҵәҩанҵәылатәу аиҟаратәра	Вертикальное выравнивание текстового виджета
Аблакнот иарбан гану агәылаҵақәа ахьыҟоу	На какой стороне блокнота помещаются вкладки
Акаҵкәыр адыргаҷа аусуратә еишәаҿы иҟоуп	Значок корзины присутствует на рабочем столе
Апытҟәырла аиҵаргыла ахы аԥсахразы анапхгара ахәҭа	Элемент управления для замены заголовка столбца кнопкой
Амаругақәа рпанель ашәагаа ардураан рҽеиҵырхуама ахәҭақәагьы	Расширяются ли элементы при увеличении размера панели инструментов
Ари ацаԥха шьақәыргылазар, аусуруга пытҟәыр  алашара аҵарԥхалоит арбага анақәку.	Если этот ключ установлен, кнопка запуска подсвечивается при наведении на неё указателя.
Анапхгара апульт аган, аангыларҭа акәаԥ ала еиҟаратәу апульт аусура аанкыларазы.	Сторона пульта управления, выровненная по точке парковки для парковки пульта управления.
Ари асерверахь еснагьтәи аимадара аԥҵтәуп	Создать постоянное соединение с этим сервером
Ари ацаԥха шьақәыргылазар, ҿыц иаԥҵахо аԥенџьырқәа иубарҭахоит апанель амыругақәа.	Если этот ключ установлен, вновь создаваемые окна будут иметь видимую панель инструментов.
Аиҭагага ацәаҳәа иминимуму аура	Минимальная длина полосы прокрутки
Афаил анапхгара архиара адиалог	Диалог настроек управления файлами
Ари аԥенџьыр ихадоу амыругақәа рпанель аԥшра ԥсахтәуп	Изменить видимость основной панели инструментов этого окна
Аҭаӡ азы ахархәаратә фон ишыҟоу еиԥш ишьақәыргылоума.	Установлен ли пользовательский фон по умолчанию для папок.
Ари ацаԥха шьақәыргылазар, апанель аекран аркра азин анаҭрм. Иашьашәалоу амениу апункт ахь унеиртә иҟалом.	Если этот ключ установлен, панель не будет позволять блокировать экран. Соответствующий пункт меню будет недоступен.
Адыргаҷа ахәҭа аган аҿы анырԥшра	Отображать значок рядом с элементом
Иаабатәу аформаҿ афаил азы азин.	Права на файл в восьмеричной форме.
Амениу аартразы арыдыркыра арыдқәа реилаҵа.	Комбинация клавиш клавиатуры для открытия меню.
Аҭагалараз ма арбаразы афаил ахьӡ	Имя файла для загрузки и отображения
Ҵәҩанҵәылатәи ахыц  аиҭагага аура	Длина вертикальной стрелки прокрутки
Иаҿыгоу ахәҭа шаҟа еиҭагатәузеи гәҵәыла, апытҟәыр иагәҭасны иҟазар	На сколько переместить дочерний элемент по вертикали, если нажата кнопка
Арастр акәаԥқәа рхыԥхьаӡара, ахырхага ииагахаанӡа иҟазаарц ахьалшо	Число точек растра, на которое может сместиться курсор до перетаскивания
Иалкаау аҭаӡ азы иаԥҵатуп агәылаҵа	Создать закладку для выделенной папки
Ари ацаԥха ишьақәнаргылоит апрограмма, аамҭа арбаразы аусура иалаго.	Этот ключ определяет программу, которая запускается для установки времени.
Иаҿыгоу авиджет, аекранаҽ апытҟәыр аиекст аганаҿ ицәырҵуа	Дочерний виджет, появляющийся на экране рядом с текстом кнопки
Акьыԥхьра аҭагылазаашьа	Состояние операции печати
Афаилтә системаҿ ахархәара змоу арныҟҿага ахьӡ	Наименование используемого движка файловой системы
Иҭацәу аҳәаа аҭбаара иаҿыгоу аконтеинер аобиектқәа рынахыс	Ширина пустой границы за пределами дочерних объектов контейнера
Иақәнагоу аԥшь аԥшаара залмыршахеит	Не удаётся найти подходящее приложение
Ахархәаҩ  ишәагаақәа напхгара рзура	Управление пользовательскими размерами
Зыҽзырҭбаауа аиҵаҩ иазалхтәуп аиҵаҩ	Задать колонку для расширяемой колонки
Аконтекст абуфер азы агәынкылара аизшара залшом	Невозможно распределить память для буфера контекста
Елементқәак акаҵкәырахь аиҭагара амуит, архыҳәышьа амамкәа иаԥыхтәума? 	Некоторые элементы не удалось переместить в корзину, удалить их безвозвратно?
Иазгәаҭоу агылара арежим	Режим фиксированной высота
Агәылаҵа аршшара ашәагаа	Размер сглаживания вкладки
Адокумент уажәтәи адакьа	Текущая страница документа
Акьыԥхь архиара аҿыхтәуп	Отключить начтройку печати
Аҭаацәаратә ҭаӡ аарттәуп	Открыть родительскую папку
Ашрифт ахышәара аекранаҿ ишыҟоу еиԥш	Параметры шрифта на экране по умолчанию
Ахышәарақәа, иаҿыгоу ахәҭақәа цәҩанцәыла рхымҩаԥгашьа узырбо	Параметры, определяющие вертикальное поведение дочернего элемента
Ари аԥхьа шәызҭааз адрес ахь ииастәуп	Перейти к предыдущему посещенному адресу
Иалкаау агәылаҵа аԥыхтәуп	Удалить выделенную закладку
Абзацтә хьаҵра, пиксельла	Абзацный отступ, в пикселях
Илхәу атом иформатрктәуп 	Форматировать выбранный том
Ҵәҩанҵәылатәи аиҭагага цәаҳәа анубаалартә ианыҟало	Когда будет отображаться вертикальная полоса прокрутки
Ишьақәыргылазар, аҭаӡҩыра абларҭқәа рыҭбаареи ргылареи еиҟароуп	Если установлено, то ячейки таблицы имеют одинаковую высоту и ширину
Ахархәаҩ  ишәагаақәа напхгара рзура.	Управление пользовательскими размерами.
Агәылаҵа ҵәҩанҵәытәи аҳәаа	Вертикальная граница вкладки
Амениу ахәҭа абираҟ амаума	Имеет ли элемент меню флажок
Ари атег аԥхьатәи аплан аԥштәы азнауама	Влияет ли этот тег на цвет переднего плана
Иалшәо амениу адаԥа амоума иаҿыгоу аелемент иахыкәшо	Имеет ли выпадающее меню рамку вокруг дочернего элемента
Аиҵаргылақәа рыхқәа акәыӷәӷәара рныруеит	Заголовки столбцов чувствительны к нажатиям
Апанель ахырхарҭаз абжьгара	Указание на ориентацию панели
Иқәгалатәуп изхылҵызи дареи	Уничтожать вместе с родителем
Ашәыгатә қәыԥшылара, аҟьаԥсрақәа аинтерпретациа ахьаиуа	Цветовое пространство, в котором плоскости интерпретируются
Амаругақәа рпанель ахырхарҭа	Ориентация панели инструментов
Аемблемазы ахьӡ ҿыц ҭажәгал:	Введите новое имя для эмблемы:
Ахьаҵ асахьеи адыргеи пиксельла ирыбжьаӡо 	Отступ в пикселях между изображением и меткой
Акаҵкәыр аҩныҵҟа азхьаԥшқәа раԥҵара ҟалом.	Вы не можете создавать ссылки внутрь корзины.
Афаил ҟазшьа адиалог аҟны анеирҭа инеиҵыху азин арбатәуп	Показывать расширенные права доступа в диалоге свойств файла
Аиҟәыҭхагақәа иҵәҩанҵәылатәу цәаҳәахома ма баша иҭацәхома	Будут ли разделители вертикальными линиями или просто пустыми
Акаҵкәыр ахь еиҭамгакәа, иалкаау елементцыԥхьаӡа аԥыхтәуп	Удалить каждый выделенный элемент, не перемещая его в корзину
Атектс зегьы бзацк аҿы аиқәырхара аҭахумашь	Следует ли сохранять весь текст в одном абзаце
Ари асеанс азы абызшәа алшәх:	Выберите язык для этого сеанса:
Адаҟьа ишыҟоу еиԥш архиарақәа	Настройки страницы по умолчанию
Ахарахәаҩтә фон шьақәыргылоуп	Установлен пользовательский фон
Анаҩстәи ҳазҭааз аҭыԥаанкыларахь ахь иастәуп	Перейти к следующему посещённому местоположению
Аҳәаақәа аҭбаара ихадоу адиалог акәша-мыкәша	Ширина границы вокруг области основного диалога
Абларҭқәа рыбжьара ииаалоу абжьажь. Еиҩшоу хыԥхьаӡаразароуп	Горизонтальный пробел между ячейками. Должен быть четным числом
Аиагаразы аҽазыҟаҵара иаҿуп.	Идёт подготовка к перемещению.
Адресқәа рыхьӡынҵа шәрыцқьар, хнырҳәышьа рымамкәа ианыҵуеит.	Если вы очистите список адресов, они будут удалены безвозвратно.
Ари ацаԥха шьақәыргылазар, апанель азин унаҭом асеанс алгара. Иашьашәалоу амениу апункт ахь унеиртә иҟалом.	Если этот ключ установлен, панель не будет позволять завершать сеанс. Соответствующий пункт меню будет недоступен.
Аиҟәшагақәа рсахьа ҭыххома ма иҭаҵәны иаанхома	Будут ли разделители нарисованы или будут пустыми
Афаил аарттәуп иарбоу адрес ала	Открыть файл по указанному адресу
Ҵаҟатәи ирҭбаау агантәи апанель	Нижняя расширенная краевая панель
Аввиджет аҭагала ахы ианархәома	Будет ли виждет использовать ввод
Ари атег афон агылара ианыруама	Влияет ли этот тег на высоту фона
Арбага ашьҭахь иашьҭоума алкаара	Следует ли выделение за указателем
Ари атег ашрифт астиль ианыруама	Влияет ли этот тэг на стиль шрифта
Афаилқәа рықәсра аан аарԥшлатәуп	показывать файлы при щелчке на них
Ишьакәыргылазар, иаҿыгоу ахәҭа еиҵацалазар ҟалоит ҳаззыҳәо ашәагаақәаинарықәырԥшны	Если установлено, то дочерний элемент может быть сжат относительно запрошенных размеров
Ари атег ашрифт ашәагаа ианыруама	Влияет ли этот тэг на размер шрифта
Ахәҭақәа акаҭа рҭагалараз аҭбаара	Ширина размещения элементов в сетке
Афаил атекст дыргаҷала иарбатәума	Показывать ли текст файла в значках
Иаарту аԥенџьырқәа акакала рартра апытҟәырқәа рыла	Переключение между открытыми окнами при помощи кнопок
Амаругақәа рпанель агага апытҟәырқәеи шаҟа рыбжьоу	Расстояние между тенью панели инструментов и кнопками
Ажәытә профильқәа рырхиара ииагоуп	Настройка старых профилей перенесена
Аусуратә еишәақәа аиҭагага архиара	Настройки переключателя рабочих мест
Иагоу ацәаҳәақәа рыбжьара апиксель	Пиксели между перенесенными строками
Ари атег ашрифт авариант ианыруама	Влияет ли этот тэг на вариант шрифта
Ақәыԥшылара , анапхгара ахәҭа иацырҵо армарахьынтә.	Пространство, добавляемое к элементу управления слева.
Асахьа иамоуп иаднамкыло бит ахыԥхьаӡара пиксель ахь	Изображение имеет неподдерживаемое число бит на пиксель
Асахьа ашьақәыргыларазы аминиатиур имаксималу шәагаа	Максимальный размер изображения для построения миниатюр
Авиджет аҭагарала афокус шьҭнахуама	Будет ли виджет принимать фокус ввода
Ари аҭаӡ аҭаацәаратә ҭаӡқәа арктәуп	Закрыть родительские папки этой папки
Аусуратә еишәа аԥшреи ахымҩаԥгашьеи аԥсахра, аилыркаага аиура ма аҭыҵра	Изменить внешний вид и поведение рабочего стола, получить справку или выйти
Ааигәа ахархәара змаз архив аарттәуп	Открыть недавно использовавшийся архив
Апринтер аҿы аҳасабтәқәа рхыԥхьаӡара	Число запланированных в принтере задач
Анагӡаразы адҵа аԥшаара залмыршахеит 	Не удаётся найти команду для выполнения
Азинқәа иагәыло афаилқәа рахь игатәуп	Распространить права на вложенные файлы
Адыргаҷа аҟны аҳәынаԥ ақәкраан ақәырԥшыга бжьы ианарҳәома	Воспроизводить ли образец звука при наведении мыши на значок
Ари ацаԥха шьақәыргылазар, аусуратә еишәаҿы иаарԥшхоит адыргаҷақәа,иаԥшьу атомқәа рахь иазхьаԥшуа.	Если этот ключ установлен, на рабочий стол будут помещаться значки, ссылающиеся на подсоединённые тома.
Ари ахьӡ шьақәыргылазар ҟалоит, адыргаҷа ахьӡ аҩнытә каталог аусуратә еишәаҿы ишәыԥсахыр шәҭахызар.	Это имя может быть установлено, если вы хотите переименовать значок домашнего каталога на рабочем столе.
Ари атег аԥхьатәи аплан асахьа ианыруама	Влияет ли этот тег на узор переднего плана
Афаилқәа зегь аашәыртырц шәҭахыҵәҟьоума?	Вы действительно хотите открыть все файлы?
Аҭаӡ аҟны ахәҭақәа рхыԥхьаӡара арбатәума	Показывать ли количество элементов в папке
Ари атег аҭыхратә бызшәа атекст ианыруама	Влияет ли этот тег на язык отрисовки текста
Ари аԥенџьыр адрес ацәаҳәа аԥшра ԥсахтәуп	Изменить видимость строки адреса этого окна
Аамҭалатәи афаил аартраан аилахәара ҟалеит	Произошёл сбой при открытии временного файла
Аҭыԥрбага напхгара азызуа арыдқәа ныҟәалома ахәҭақәа рыхьӡынҵала	Будут ли клавиши управления курсором перемещать по списку элементов
Ианубаало афаилқәа ралхразы уажәтәи араӡага	Текущий фильтр для выбора отображаемых файлов
Ахыԥхьаӡара 0.0 и 1.0 рыбжьара ииаалоу аиҟаратәра узырбо атекстаиндикатор апрогресс аҿы	Число между 0.0 и 1.0 указывающее горизонтальное выравнивание текста в индикаторе прогресса
Аҵакырақәа инверттәуп, иҳәазақәо рыла иалкаау, адиапазон арҭбааразы	Инвертировать области, отмеченной ползунками, для увеличения диапазона
Шьҭахьҟа иазго апытҟәыр	Кнопка перемещения назад
Аинформациатә дырраҭара	Информационное сообщение
Апрограмма нагӡатәуп адҵатә цәаҳәа алагаларала	Выполнить программу путём ввода командной строки
Истандарту апытҟәыр арбара ахыц аԥхьаҟа ирханы	Отображать стандартную кнопку со стрелкой вперёд
Ианонимтәу атег ԥшаауп, атегқәа раԥҵара залшом.	Найден анонимный тег, не могут быть созданы теги.
Уажәтәи адрес азы ари амениу агәылаҵа ацҵатәуп.	Добавить закладку для текущего адреса в это меню.
Асимволқәа ажәа алызхуа:	Выбирающие слово символы:
Анахага апытҟәыр заҟароу	Размер кнопки перемещения
Асубпиксельтә хьаршшаара	Субпиксельное сглаживание
Абраузер ишыҟоу еиԥш иеилнакаауама инахароу адҵа	Понимает ли браузер по умолчанию удалённые команды
Ацәаҳәақәа ахаангьы ииагатәӡам, ажәа аҳәаа ала ма асимвол ала ииагатәхома	Никогда не переносить строки, переносить ли по границам слов или по символам
Авиджет аҳәаақәа рҳәааҿ ацәаҳәақәа риагара ҟалома	Будет ли происходить перевод строк у границ виджета
Анырра змам аҭагылазаашьа	Нечувствительное состояние
Хьӡынҵас иҟоу алаԥшхгаратә компонент агха аԥшааит.	Компонент просмотра в виде списка обнаружил оошибку.
Асеанс ахыркәшара аҿыхтәуп	Отключить завершение сеанса
Апанель аҽҵәахра аанкылара	Задержка автоскрытия панели
Ирҭбаау аҭагалара аҿыхтәуп	Выключить расширенный вывод
Аҵаҳәара агхара ажәамаӡаҿы	Задержка подсказки в пароле
Ахкырбага аанкылара, апенџьыр иҿыцу аҭыԥ анааннакыло	Задержка расширения, когда окно занимает новую область
Ахәаԥышга аԥенџьыр иаакәыршаны агага аҭыхшьа унарбоит	Определяет способ прорисовки тени вокруг окна просмотра
иалкаау ахәҭақәа ҭырффатәуп	Вырезать выделенные элементы
Асистематә лакар ахырхарҭа.	Ориентация системного лотка.
Алицензиа атекст ииагатәума	Переносить ли текст лицензии
Афаил ахьӡ мацарала аԥшаара	Искать файлы только по имени
Агәыԥ ахаҭарбага агәылаҵақәа реиҟәыҭхареи риагареи азы	Идентификатор группы для отсоединения и переноса вкладок
Ишьақәыргылазар, мыцху иауу атекст ацәаҳәақәа иианагоит	Если установлено, переносит слишком длинные строки текста
Абжьаргыларҭа акәаԥ унарбома	Показывается ли точка вставки
Апытҟәыраҿ авиджет-адырга атекст, апытҟур адырга амазар.	Текст виджета-метки на кнопке, если кнопка содержит метку.
Ишьакәыргылоуп, иҳкьыԥхьо адыррақәа ралагамҭа адақьа аханы иҟазарц ахәҭазар,иахьанубаало аҵакыра ахықәцәаҿ акәымкәа	Установлено, если начало печатаемых данных должно располагаться в вершине страницы, а не в вершине отображаемой области
Амаругақәа рпанель арбалатәуп	Показывать панель инструментов
Асинтаксис арлашага ырцәатәуп	Отключить подсветку синтаксиса
Аԥшаара акритери ҿыц ацҵатәуп	Добавить новый критерий поиска
Аиҭагаразы ахықәкы ирыцхраауеит илокалтәу афаилқәа мацара.	Цель для перетаскивания поддерживает только локальные файлы.
Акаҵкәыр ахь афаилқәа риагараан ашьақәырӷәӷәара иазҵаатәума	Запрашивать ли подтверждение при перемещении файлов в корзину
Уажәти аамҭеи арыцхәи унарбоит	Отображает текущие время и дату
Атекст адырганҵа ианубааларазы	Разметка текста для отображения
Ацәаҳәа иаҿыгоу ахәҭақәа амоуп	У строки есть дочерние элементы
Ари атег атабулиациа ианыруама	Влияет ли этот тег на табуляцию
Аԥсшьара ахырԥара азин аҭатәуп	Разрешить откладывание перерыва
иубарҭоу аҭагылазаашьа унаҭоит	предоставляет видимое состояние
Амениу аҟынтәи асценари ари асценари аус арулоит иалху аелементқәа рыла аҭагалара аҳасабла.	Выбор сценария из меню будет запускать этот сценарий с выбранными элементами в качестве ввода.
Амениуеиҵа ҵәаххаанӡа аанкылара	Задержка перед сокрытием подменю
Абри адҵа акьыԥьхьразы апринтер	Принтер для печати этого задания
Иазԥхьагәаҭам аԥштәы аҵаулара ԥшаан аԥштәқәа рыхсаала ахәҭа азы	Непредвиденная глубина цвета обнаружена для элемента карты цветов
Афаилқәа рықәсра аан нагӡалатәуп	выполнять файлы при щелчке на них
Афаил ахьӡи аҟазшьеи ала аԥшаара	Искать файлы по имени и свойствам
Ирҿыцу афаилқәа заҵәык ацҵалатәуп	Добавлять только обновлённые файлы
Адырганҵа хархәатәуп иҩбатәу аҟны	Использовать разметку во вторичном
Аилыԥшаара аиндикатор арбалатәума	Показывать ли индикатор сортировки
Иаҿыгоу амениу аилаҳәара ахырхарҭа	Направление упаковки дочернего меню
Арҭбага-ахыц иаакәыршаны абжьаӡара	Интервал вокруг стрелки-расширителя
Ари ацаԥха шьақәыргылазар, аусуратә еишәаҿы иааԥшхалоит адыргаҷақәа.	Если этот ключ установлен, на рабочем столе будут отображаться значки.
Ари аԥенџьыр аҿы аелементқәа зегьы иаокаатәуп, иарбоу ашаблон иақәшәо	Выделить в этом окне все элементы, соответствующие приведенному шаблону
Иаарԥшхо адокументқәа рыхкқәа алышәх	Выберите типы отображаемых документов
Анахага апытҟәырқәа рыбжьара ибжьаӡо	Расстояние между кнопками перемещения
Иубарҭоума ицәаху афаилқәеи аҭаӡқәеи	Показываются ли скрытые файлы и папки
Амениу ахәҭа арадио-ахәҭаны иҟалоума	Будет ли элемент меню радио-элементом
Иалху аелемент ари аԥенџьераҿ аартра	Открыть выбранный элемент в этом окне
Ари анапхгара ахәҭа агылара ашьақәыргылараз адҵаалара аԥсахра ма -1,ихалагаратәиу ашьҭаҵаа ахархәара ақәшәар	Изменение запроса на установку высоты этого элемента управления или -1, если нужно использовать исходный запрос
Алакар аиҭагага аура зегь ала иҭыхтәума ма апытҟәырқәеи абжьара аҟәыхтәума	Рисовать ли желобок во всю длину прокрутки или исключать кнопки и промежутки
Амаругақәа рпанель аҵаҳәарақәа активума	Активны ли подсказки панели инструментов
Армала, арӷьала ма агәҭаныла аиҟаратәра	Выравнивание влево, вправо или по центру
Ари атег аеллиптизациа арежим ианыруама	Влияет ли этот тег на режим эллиптизации
Афон аԥштәы мамзаргьы  аҭыхымҭа агәылоуп	Содержит цвет фона панели или изображение
Иреиҳаӡоу ахыԥхьаӡара ахәҭақәа ианубаало	Максимальное число отображаемых элементов
Ари атег апараграф афон аԥштәы ианыруама	Влияет ли этот тег на цвет фона параграфа
Ҵҩанҵәытәи аҳәаа аҭбаара агәылаҵа ахҵара	Ширина вертикальной границы меток вкладки
Апытҟәыр аиҭагага ахәҭа ананубаало иҟазар	Если отображена переключающая часть кнопки
Аԥшьы аҟны даҽа шрифтк ахархәара азутәума	Использовать ли другой шрифт в приложениях
Акаҵкәыр ахь аиасразы аҽазыҟаҵара цоит.	Идёт подготовка к перемещению в корзину.
Арбага ахәҭақәа гәыԥла аиҭныԥсахлара ауеит	Элементы просмотра можно перегруппировывать
Анапхгара ахәҭа активра азнаеит ишыҟоу еиԥш	Активизирует элемент управления по умолчанию
Ахырхага ашәагаа ма 0 ишыҟоу еиԥш ашәагаа азы	Размер курсоров или 0 для размера по умолчанию
Аҭаҵа ахәҭақәа зегьы ирымоума иеиҟароу ашәагақәа	Имеют ли все вложенные элементы одинаковый размер
Агомогентә хәҭақәа зегьы иеиҟароу ашәагаа рымоума	Имеют ли все гомогенные элементы одинаковый размер
Ажәақәа риагара ҟалома авиджет аҳәаақәа рааигәара	Будет ли делаться перенос слов на границах виджета
Раԥхьатәи аԥенџьыр аԥҵатәуп иазалху агеометриала.	Создать первоначальное окно с заданной геометрией.
Ахықәкқәа рыхьӡынҵа, ари абуфер иаднакыло аиҭныԥсахлара абуферахь ақәҭыхраан ма ахәынаԥ ала аиагара	Список целей, которые этот буфер может поддерживать при копировании в буфер обмена или переносе мышью
Асахьа абуфер аҿы аиқҿырхаразы иҟоу агәынкылара азхом	Недостаточно памяти для сохранения изображения в буфер
Иалшәо амениу афокус иааннакылома аҳәынаԥ ахыкәласраан	Перехватывает ли выпадающее меню фокус при щелчке мышью
Ишьақәыргыламзар, адаԥа аҟнытәи адәнытәи ахәҭа аннахуеит	Если не установлено, то удаляет из элемента внешнюю рамку
Асахьа адиалог ардырраҿи ахьаҵ аҭбаареи ахҵара иаарыкәыршаны	Ширина отступа вокруг метки и изображения в диалоге сообщения
Имаксимуму ақәыԥшылара, хәҭацыԥхьаӡа еиҵырхуа аелеменқәа иаанныркыло	Максимальное пространство, занимаемое каждым из расширяемых элементов
Аҭагаларҭатә ҭыԥ ахәҭақәа рыҟны аҵыхәтәан иҭагалаз асимвол иабанӡарбахо	Как долго показывать последний введённый символ в элементах ввода пароля
Аԥенџьыр агылара ишыҟоу еиԥш, ухы иауырхәоит раԥхьаӡа аԥенџьыр ианаарԥшхо	Высота окна по умолчанию, используется при первоначальном отображении окна
Аҩнтәи аҭаӡ ахь ииастәуп	Перейти в домашнюю папку
Амыругақәа рпанель астиль	Стиль панели инструментов
Ари акомпиутер аҿыхтәума?	Выключить этот компьютер?
Агәылаҵа армарахь анахара	Переместить вкладку влево
Аҵәцара ахархәара аҭатәуп	Использовать прозрачность
Абыкь бжьы азы афаил ахьӡ	Имя файла для звука гудка
Акурсор кәеицеир ахәҭоума	Следует ли мигать курсору
Иарбоу ацәаҳәахьы ииастәуп	Перейти к указанной строке
Аинтернет аамҭа арбалатәуп	Показывать время Интернета
Агәылаҵа аргьарахь анахара	Переместить вкладку вправо
Аҭаацәаратә ҭаӡқәа арктәуп	Закрыть родительские папки
Аԥшааразы акаталог алхтәуп	Выбрать каталог для поиска
Иаԥыхыз аҟаҵара ыргьежьтәуп	Вернуть отменённое действие
Армаратәи агәҭантәи апанель	Левая центрированная панель
Ахҵараҿы ашәагаа хархәатәуп	Использовать размер в метке
иҵәаху афаилқәа анырԥштәума	отображать ли скрытые файлы
Асистематә сеанс ишыҟоу еиԥш	Системный сеанс по умолчанию
Адаҟьа апараметркәа рхиатәуп	Настроить параметры страницы
Акәалаԥ автоматла иарклатәуп	Автоматически закрывать ящик
Арыдыркыратә мениу арццакыга	Клавиатурный ускоритель меню
Иалшәх аемблемаз даҽа хьӡык.	Выберите другое имя эмблемы.
Зхы иақәиҭу агәынкылара азхом	Недостаточно свободной памяти
Асахьа амениу аҿы иарбалатәуп	Показывать изображения в меню
Ҵәҩанҵәылатәи аиҭагага цәаҳәа	Вертикальная полоса прокрутки
Еиҭаҵуа аԥенџьыр аҭагылазаашьа	Положение прокручиваемого окна
Ахархәаҩ изы аус аруга апытҟәыр	Пользовательская кнопка запуска
Адырга ҵәҩанҵәылатәи аиҟаратәра	Вертикальное выравнивание метки
Амыругақәа иацрырхуа апонельқәа	Отцепляемые панели инструментов
Афаил ахьӡ афон азы ишыҟоу еиԥш	Имя файла для фона по умолчанию
Аилыԥшаара аихшашьа ишыҟоу еиԥш	Порядок сортировки по умолчанию
Ари аҭаӡ акаҵкәырахь еиҭагатәуп	Переместить эту папку в корзину
Ари асистематә сеанс ишыҟоу еиԥш	Это системный сеанс по умолчанию
Ҵәҩанҵәылатәи аиҟәыҭхага аҭбаара	Ширина вертикального разделителя
Абларҭқәа ирымоу анырра арбалатәуп	Показывать чувствительность ячейки
Аус азыруа апытҟәыр аиқәырхара ауам	Не удаётся сохранить кнопку запуска
Агәылатә цәаҳәақәа рыбжьара ибжьаӡо	Расстояние между соседними строками
Уажәтәи иазгәаҭоу аҭбаара аицаргылаз	Текущая фиксированная ширина столбца
Аԥшааратә критери аԥшаага панель азы	Критерий поиска для поисковой панели
Аԥшаара аиқәырхаразы акаталог алхтәуп	Выбрать каталог для сохранения поиска
Апрограмма автор изин иазку адырраҭара	Информация о авторском праве программы
Показывать только текущее рабочее место	Показывать только текущее рабочее место
Ицхыраагӡоу апытҟәыр шьҭахьҟа аиагаразы	Дополнительная кнопка перемещения назад
Иарбоу афаил даҽа хьӡык ала еиқәырхатәуп	Сохранить текущий файл под другим именем
Уаанӡа ҳазҭааз аҭыԥаанкыларахь ахь иастәуп	Перейти к посещённому ранее местоположению
Атекст, апрогресс аиндикатор аҿы ианубаало	Текст, отображаемый в индикаторе прогресса
Шыззынархоу адиск аԥхьара мацара шәақәиҭуп.	Диск назначения доступен только для чтения.
Шәара иақәнагоу азин шәымам ари аҭаӡ аҭаҩра.	У вас недостаточно права записи в эту папку.
Амениу аелементқәа рҿы адыргаҷқәа аарԥштәуама	Следует ли отображать значки в элементах меню
Иалкаатәуп аус аруразы атерминал аԥенџьыр аҿы.	Отметить для запуска команды в окне терминала.
Анаскьагага ацәаҳәа аҭбаара ма амасштаб арбага	Ширина полосы прокрутки или указателя масштаба
Иалкаау елемент цыԥҳьаӡа акаҵкәырахь еиҭагатәуп	Переместить каждый выделенный элемент в корзину
Агәынкылара аихшара залшом ацәаҳәа адыррақәа рзы	Невозможно распределить память для данных строки
Агәынкылара аихшара залшом апалитра рдыррақәа рзы	Невозможно распределить память для данных палитры
Ихадоу амениу аҟны амениуеиҵа цәырҵаанӡа аанкылара	Задержка перед появлением подменю у основного меню
Ас еиԥш иҟоу акадрқәа реишьҭагыла анимациаҿы ииашам	Данная последовательность кадров в анимации неверна
Ари аԥшьы аҿы ахархәара змоу, аидентификатор ацәаҳәа	Строка идентификатора, используемая этим приложением
Аелемент ықәгахар, иара архыҳәышьа амамкәа иаҳцәыӡуеит.	Если вы удалите элемент, он будет окончательно утрачен.
Автохыркәшара авариантқәа анубаалома иалшәо аԥенџьыр аҟны	Отображаются ли варианты автозавершения в выпадающем окне
Ари адрес аарԥшраан алаԥшхаратә компонент ахьӡынҵеиԥш иаарԥштәуп.	Использовать просмотр в виде списка при отображении этого адресе.
Аганахьтәи апанель азы ахархәаратә фон ишыҟоу еиԥш ишьақәыргылоума.	Установлен ли пользовательский фон по умолчанию для боковой панели.
Иаҿактәуп ицхыраагӡоу алшарақәа ацәаҳәақәа рынҵәамҭақәа асахьа ҭызхуа	Включить дополнительные возможности темы по отрисовке окончаний строк
Иуникалтәу ԥенџьыр ахаҭарбага, асессиа аиҭашьақәыргылараан ихархәагоу	Уникальный идентификатор окна, используемый при восстановлении сессии
Ацхыраара зҭаххо апрограммақәа аус аруразы, ахархәара ззухо атерминал	Терминал, который используется для запуска нуждающихся в нём программ
Аԥенџьыр аҭбаара ишыҟоу еиԥш, раԥхьаӡа аԥенџьыр аарԥшраан ахархәара аиуеит	Ширина окна по умолчанию, используется при первоначальном отображении окна
Ари ацаԥха шьақәыргылазар, апанель аобиектқәа рзы иаарԥшхалоит ихыло аҵаҳәарақәа. 	Если этот ключ установлен, для объектов панели отображаются всплывающие подсказки.
Исимволикатәу ашәагаа иҭасоу адыргаҷа азы, адыргаҷакәа реизга ма ахьӡ змоу адыргаҷа	Символический размер для встроенного значка, набора значков или именованного значка
Ари ахьӡ шьақәыргылазар ҟалоит, акаҵкәыр адыргаҷа ахьӡ аусуратә еишәаҿы ишәыԥсахыр шәҭахызар.	Это имя может быть установлено, если вы хотите переименовать значок корзины на рабочем столе.
Ари ацаԥха  шьақәыргылазар, аиҭагага аусуратә еишәақәа зегьы унарбалоит, уажәтәи мацара акәымкәа.	Если этот ключ установлен, переключатель будет показывать все рабочие места, а не только текущее.
Ахықәкқәа рыхьӡынҵа, ари абуфер иаднакыло аиҭныԥсахлара абуфер аҟнытә ақәҭыхраанма ахәынаԥ ала аиагаран	Список целей, которые этот буфер может поддерживать при вставке из буфера обмена или при переносе мышью
Адәныҟатәи ахаргьежьра аҟны иалышәх ишәҭаху аԥштәы. Иалышәх еиҳа илашьцоу маилашоу апштәхәы, аҩнуҵҟатәи ахкәакь ахархәарала.	Выберите желаемый цвет на внешнем круге. Выберите более тёмный или более светлый оттенки, используя внутренний треугольник.
Аусуратә еишәа аиҭагага иунарбоит ирмаҷу аусуратә еишәа аверсиа, аԥенџьырқәа рнапхгара азин унаҭо.	Переключатель рабочих мест показывает уменьшенную версию рабочих мест, позволяя управлять окнами.
Ари ацаԥха шьақәыргылазар, ҿыц иаԥҵахо аԥенџьырқәа рҿы иубарҭахоит аганахьтәи апанель.	Если этот ключ установлен, вновь создаваемые окна будут иметь видимую боковую панель.
Акаҵкәыр аҭаӡ ахархәара азухоит ахәҭақәа рыҵәахразы, акаҵкәыр ахь иҭагалоу.	Папка корзины используется для хранения элементов, перемещенных в корзину.
Ишьақәыргылоуп, акьыԥхьраан иубозар уажә ҳазҭагылоу адиалог аҭагылазаашьа.	Установлено, если во время печати показывается диалог текущего состояния.
Аилыркаага ахәаԥшра апрограмма ишыҟоу еиԥш аҭахны иҟоума атерминал	Нуждается ли программа просмотра справки по умолчанию в терминале
Амодель, изылшар ҟало апараметрқәа иалшәо ахьӡынҵа згәылоу	Модель, содержащая возможные параметры выпадающего списка
Афаилқәеи аҭаӡқәеи ииагазар мацара ҟалоит акаҵкәырахь.	Файлы и папки могут быть только перемещены в корзину.
Аҭаӡ аҟны аус зыдулахо афаилқәа рмаксималтә хыԥхьаӡара	Максимальное количество обрабатываемых файлов в папке
Атемақәа рҿы ахархәура змоу ахьыӡқәа змоу апалитрақәа	Палитра именованных цветов для использования в темах
Аиндиккатор апрогресс аҭыԥырбагеи аизҳара ахырхарҭеи	Ориентация и направление роста индикатора прогресса
Ишьақәыргылазар, ааиҭагага активтә ҭагылазаашьа ианҭагылоу сахьаҵасианубаалоит ахархәараан аагага ацны	Если установлено, прокрутка будет отрисовываться в активном состоянии с тенью во время использования
Ари ацаԥха шьақәыргылазар, ишыҟоу еиԥш аԥенџьыр ҿыцқәа ахархәара рзухоитижәпоу адыргаҷақәа ранҵара.	Если этот ключ установлен, по умолчанию новые окна будут использовать плотное размещение значков.
Аҭыхымҭа аарҳәлатәуп ҵәҩанҵәылатәи апанельқәа рҿы	Поворачивать изображение на вертикальных панелях
Амасштабркра уажәтәи ахкы аҩаӡара шьақәыргылатәуп	Установить уровень масштабирования текущего вида
Шәара панельк иадамзаргьы еснагь ишәымазароуп.	У вас всегда должна быть хотя бы одна панель.
Афаилтә менеџьер аҟны аҩнытәи аҭаӡ алаԥшхгара	Просмотр домашней папки в файловом менеджере
Ари ацаԥха шьақәыргылазар, ҿыц иаԥҵахо аԥенџьырқәа рҿы иубарҭахоит ацәаҳәа аҭагылазаашьа.	Если этот ключ установлен, вновь создаваемые окна будут иметь видимую строку состояния.
Аԥхьаӡага-апытҟәыр аҵакы зыхьчо, аҷыдақазшьа	Свойство, хранящее значение кнопки-счётчика
Ианубаало ижәабатәиу аразриадқәа рхыԥхьаӡара	Количество отображаемых десятичных разрядов
Иалшәо аелементқәа аиҟәҟьара цәаҳәа рымоума	Имеют ли выпадающие элементы линию разрыва
Хыхьтәи аҩаӡара апанель, иагәылоуп аобиект	Панель верхнего уровня, содержащая объект
Илкаау елементцыԥхьаӡа адубль азыҟаҵатәуп	Продублировать каждый выделенный элемент
Ахәҭақәеиа аномерқәа ирыцны иарбалатәума	Показывать ли элементы вместе с номером
Афаил ҿыц аԥҵатәуп иазалху акаталог аҿы	Создать новый файл в заданном каталоге
Аиҭагага ацәаҳза ишьақәыргылоу ашәагаа	Фиксированный размер полосы прокрутки
Афаилқәа ррезервтә копиақәа арбатәума	Показывать ли резервные копии файлов
Ааигәа ахархәара змаз афаил аарттәуп	Открыть недавно использованный файл
Автоматла апанель акәакь ахь аҵәахра	Автоматически прятать панель в угол
Асеиԥш иҟоу адыргаҷ ахкы аднакылаӡом	Данный тип значка не поддерживается
Атекст аҵыхәтәантәи аԥсахра аԥыхтәуп	Отменить последнее изменение текста
Амаругақәа рпанель адыргаҷа ашәагаа	Размер значков панели инструментов
Асахьа апытҟәырқәа рҿы иарбалатәуп	Показывать изображения на кнопках
Анырра змам апытҟәыр аҭагылазаашьа	Нечувствительное состояние кнопки
Аус ацашьа узырбо аиндикатор аҵакы	Значение индикатора хода процесса
Армаратәи ирҭбаау агантәи апанель	Левая расширенная краевая панель
Арыдқәа ркомбинациа уԥсахыр ауеит	Можно изменять комбинации клавиш
Иаарԥшхо аиҵаргылақәа рхыԥхьаӡара	Количество отображаемых столбцов
Иажәыз аҷыдаҟазшьа, гәыгәҭажьхоит	Устарелое свойство, игнорируется
Аҭагылазаашьа адыргаҷа анубаалома	Отображается ли значок состояния
Ауыс аура алагараан алаԥшхгаратә хьӡынҵа акомпонент агха аԥшааит.	Компонент просмотра в виде списка обнаружил ошибку при запуске.
Аиҵаргыла ашәагаа аԥсахра арежим	Режим изменения размера столбца
Аҵла акаҭа ацәаҳәақәа арбалатәуп	Показывать линии в сетке дерева
Аҽҭаҩра аҽазышәара лыҵшәадахеит.	Попытка регистрации не удалась.
Апараграф афон аԥштәы цәаҳәаҵас	Цвет фона параграфа как строка
Иаҿыгоу авиджет, аекранаҿ ицҿырҵуа амениу аманиу атекст аганаҿ	Дочерний виджет, появляющийся на экране рядом с текстом меню
Даҽа хәаԥшыгатә программак алышәх нас даҽазнык шәҽазышәшәа.	Выберите другую программу просмотра и попробуйте еще раз.
Ари атег ахьаҵ анырра анаҭома	Влияет ли этот тег на отступ
Акаҵкәыр ахь афаилқәа риагара	Перемещение файлов в корзину
Ақәыԥшылара , анапхгара ахәҭа иацырҵо анапхгара хыхьынтә.	Пространство, добавляемое к элементу управления сверху.
Ишьакәыргылоуп, акьыԥхьра аҳасабтә иаҳнаҭозар адырра иара аҭагылазаашьа шыҟоу, адыррақәа апринтер ахь ма акьыԥхь асервер ахь иандәықәҵахалагь.	Установлено, если задача печати будет сообщать о своем состоянии даже после того, как данные будут отосланы на принтер или сервер печати.
Иажәыз афаилқәа бжьажьлатәуп	Пропускать устаревшие файлы
Аҵаҳәараҿы арыцхә арбалатәуп	Показывать дату в подсказке
Аредакциалшара шьақәыргылоуп	Редактируемость установлена
Ашрифт араӷара шьақәыргылоуп	Разрядка шрифта установлено
Ақәыԥшылара , анапхгара ахәҭа иацырҵо анапхгара ҵаҟантә.	Пространство, добавляемое к элементу управления снизу.
Ҳаҭамыз, аха шәара азин шәымам аԥыхра аҭыхымҭа  аԥсахра.	Извините, но вы не можете заменить изображение сброса.
Ари атег аашрифт ашәагаа масштабркраа ауама коефицентла	Масштабирует ли этот тег размер шрифта на коэффициент
Уажәтәи акаталог арбалатәуп	Показывать текущий каталог
Интерактивла атекст аԥшаара	Интерактивный поиск текста
Амениу ацәаҳәа аԥхьага арыд	Клавиша вызова строки меню
Еиҭаку аԥшаара еиқәырхатәуп	Сохранить измененный поиск
Асахьарбагатә фаил аиқәырхаразы иҟоу агәынкылара азхом	Недостаточно памяти для сохранения файла изображения
Аилыркаага ахәаԥшра апрограмма аҭахны иҟоума атерминал	Нуждается ди программа просмотра справки в терминале
Анацҳақәа ржурнал арбатәуп	Показать журнал сообщений
Ахархәаҩ изкны аинформациа	Информация о пользователе
Амениу аилаҳәара ахырхарҭа	Направление упаковки меню
Аус арураан абжьы аҿактәуп	Включить звук при запуске
Агәаҽанызааратә рдырраҭара	Предупреждающее сообщение
Аԥшәма иԥсахра аҟәыхтәума?	Отменить смену владельца?
Шәақәыӷәӷәа, шәеиԥыларақәеи шәыдҵақәеи шәрыхәаԥшырц	Щелкните, чтобы просмотреть свои встречи и задачи
Ашрифт ахҳәаа, аусуратә еишәаҿы адыргаҷақәа аҵаҩымҭа әасабла ахархәара зауа.	Описание шрифта, использующегося для подписей к значкам на рабочем столе.
Иагәылоу аҭаӡқәа аҿактәуп	Включать вложенные папки
Апанель зынӡаск аанкылара	Полная блокировка панели
Апанель ашәагаа пиксельла	Размер панели в пикселях
Аиҭанҵара ашьақәырӷәӷәара	Подтверждение перезаписи
Адаҟьа ашьашәалара ашәага	Размер страницы подгонки
Иҵәаху афаилқәа аарԥштәуп	Показывать скрытые файлы
Аҳатә серверқәа афаилтә менеџьер аҟны ирыхәаԥштәуп	Просмотреть сетевые серверы в файловом менеджере
Шаҟа миллисекунд аҭахузеи аццакра шьҭнахырц азы 0 инаркны максимум аҟынӡа	Сколько миллисекунд требуется для набора скорости от 0 до максимальной
Уажәтәи адаҟьа акьыԥхьра	Печать текущей страницы
Авиджет убаратәы иҟалома	Будет ли виджет видимым
Аҭаӡқәа мацара раарԥшра 	Показывать только папки
Асценариатә ҭаӡ аарттәуп	Открыть папку сценариев
Ақәыпшылара, акаҭа ацәаҳәақәа рыбжьара ибжьагыло	Пространство, вставляемое между строками сетки
Ахарахәаҩтә фон аганахьтәи апанель шьақәыргылоуп	Установлен пользовательский фон боковой панели
Ари ацаԥха шьақәыргылазар, ҿыц иаԥҵахо аԥенџьырқәа рҿы иубарҭахоит ацәаҳәақәа адрес аҭагалара.	Если этот ключ установлен, вновь создаваемые окна будут иметь видимую строку ввода адреса.
Аелементқәа акаҵкәырахь аиҭагара амуит, рхыҳәышьа амамкәа иаԥыхтәума? 	Не удалось переместить элементы в корзину, удалить их безвозвратно?
Ҳазну аиҵаргыла аҭбаара	Текущая ширина столбца
Азгәаҭазы аҭакыра алхра	Выбор поля для отметки
Афон аԥштәы ишыҟоу еиԥш	Цвет фона по умолчанию
Ашаблонқәа шьақәыргылам	Шаблоны не установлены
Еиҟаратәны еиқәырхатәуп	Сохранять выровненными
Алокалтә фаилқәа мацара	только локальные файлы
Ари аԥенџьыр аганахьтәи апонель аԥшра ԥсахтәуп	Изменить видимость боковой панели этого окна
Исимволтәу азхьарԥшқәа акаталог аҿы иалхтәуп	Исключать символические ссылки на каталоги
Ари атег ацәаҳәақәа риагара арежим ианыруама	Влияет ли этот тег на режим переноса строк
Ари ацаԥха адҵа шьақәнаргылоит, аԥсыз асахьа иақәкны ақәықшараан.	Этот ключ определяет команду, выполняемую при щелчке на рыбке.
Анимациа аҭагаларазы агәынкылара иҟоу азхом	Недостаточно памяти для загрузки анимации
Ҵҩанҵәылатәи абжьажь абларҭқәа рыбжьара. Еиҩшоу хыԥхьаӡаразароуп	Вертикальный пробел между ячейками. Должен быть четным числом
Аилыркаага ишыҟоу еиԥш ахәаԥшра апрограмма	Программа просмотра справки по умолчанию
Ишьақәыргылазар, ахархәаҩ ихала иԥсахыр ҟалоит аԥенџьыр ашәагаа	Если установлено, то пользователь может изменять размер окна
Иалкаау ахәҭақәа архив аҟнытә ианыхтәуп	Удалить выделенные элементы из архива
Ишьақәыргылоу афаилқәа рыԥшааразы амҩа	Путь для поиска установленных файлов
Азхьарԥш аԥҵаразы аҽазыҟаҵара иаҿуп.	Идёт подготовка к созданию ссылок.
Афаилқәа раныхразы аҽазыҟаҵара цоит.	Идёт подготовка к удалению файлов.
Иҵәахыуи арезервтә фаилқәа арбалатәуп 	Показывать скрытые и резервные файлы
Атемақәа рпроцессор иазалхтәуп аҵаҳәага ацәаҳәақәа еиуеиԥшым ԥштәыларышәразы	Задать подсказку для процессора тем для окрашивания строк в разные цвета
Аԥенџьыр адаԥа аркыга апытҟәыр амоума	Имеет ли рамка окна кнопку закрытия
Амениу аиҟәҟьара цәаҳәа амазар ҟалома	Следует ли меню иметь линию разрыва
Иаарту аҭаӡ рхынхәышьа амамкәа аԥыхра	Окончательно удалить открытую папку
Уажәтәи адокумент абызшәа еилкаатәуп	Установить язык текущего документа
Агәылаҵақәа рыхҩара аҵакыра ашәагаа	Размер области перекрытия вкладок
Ари атег арӷьатәи аҭакыра ианыруама	Влияет ли этот тег на правое поле
Ахьӡ ҭагаланы даҽазнык шәҽазышәшәа.	Введите имя и попробуйте еще раз.
Амаҭахәқәа рпанельаҿ адыргаҷақәа рышәагаа ишыҟоу ала	Размер значков в панели инструментов по умолчанию
 Ари ацаԥха шьақәыргылазар, асекундақәа убарҭахоит.	Если этот ключ установлен, отображаются секунды.
Апытҟәыр иагәҭасны ианыҟоу аԥхьатәи аанкылара аамҭа	Время первоначальной задержки при нажатии кнопки
Иеиҵацалоу адыргаҷқәа аднакылаӡом	Сжатые значки не поддерживаются
Амыругақәа апанель аҟны адыргаҷқәа рышәагаа аҵакы	Значение размера значков в панели инструментов
Ари аԥенџьыр аҭагылазаашьа ацәаҳәа аԥшра ԥсахтәуп	Изменить видимость строки состояния этого окна
Аҟашьарбагақәа рыхьӡынҵа астиль, иубарҭоу атекстаҿ ахархуара змоу	Список атрибутов стиля, применяемых к визуализируемому тексту
Иалкаау ахәҭақәа ркопиа ахыхтәуп	Копировать выделенные элементы
Афаилқәа зегь ралкаара аҟәыхтәуп	Отменить выделение всех файлов
Иалкаау афаилқәа рыхьыӡ ԥсахтәуп	Переименовать выделенные файлы
Абларҭа афон аԥштәы асахьа аҭаны	Цвет фона ячейки в виде строки
Арнаара астиль аҭаҵа иаакәыршаны	Стиль скоса вокруг содержимого
Ахҵара ақәыԥшыларазы ихархәатәуп	Использовать метку для образца
Ашрифт ахьӡ ишыҟоу еиԥш, адокументқәа раԥхьаразы ахархәара ззухо	Имя шрифта по умолчанию, используемого для чтения документов
Акаҵкәырахь аиҭагара амуит, афаил архыҳәышьа амамкәа иаԥыхтәума?	Не удалось переместить в корзину, удалить файл безвозвратно?
Адиалог иамоу аиҟәшага цәаҳәа апытҟәырқәа рханы	Диалог имеет полосу разделителя над кнопками
Ари атег атекст аредакциаҟаҵара анырра азнауама	Влияет ли этот тег на редактируемость текста
Адәахьтәи абжьаӡара ишыкоу еиԥш	Внешний интервал по умолчанию
Арастрт ацәахәа аиҭагагеи аԥенџьыр еиҭагагеи ирыбжьаӡо акәаԥқәа рхыԥьхьаӡара	Количество точек растра между полосами прокрутки и прокручиваемым окном
Апанель аԥыхра ашьақәырӷәӷәара	Подтверждать удаление панели
Аԥшаара нагӡатәуп ма ирҿыцтәуп	Выполнить или обновить поиск
Иалкаау атекст аԥсахра абуфер ахь иақәҭыхтәуп	Копировать выделенный текст в буфер обмена
Ацәаҳәа амениу атерминал ҿыц аҿы иарбалатәуп	Показывать в новых терминалах строку меню
Аҵыхәтәантәи аҟаҵара аԥыхтәуп	Отменить последнее действие
Иурхиар иҟало агәылаҵа ахҵара	Настраиваемая метка вкладки
Афаил аартны аԥенџьар арктәуп	Открыть файл и закрыть окно
Ишьақәыргылазар, амзар аҿы амчыбжьқәа рномерқәа арбалатәуп	Если установлено, показывать номера недель в календаре
Аимадаратә сервер аҽамадара шьақәыргылатәуп	Установить соединение с сетевым сервером
Акьыԥхь ақәырԥшы иахәаԥштәуп	Просмотреть образец печати
Убас егьырҭгьы, егьырҭгьы.	и многие, многие другие.
Аобиект апанель аҿы иаҭатәуп	Закрепить объект на панели
 Аусуратә еишәақәа рыхьӡқәа:	Наименования рабочих мест:
Ахҭысқәа ашәагаақәа рыԥсахра	События изменения размеров
Ианубаало адыргаҷақәа реизга	Отображаемый набор значков
Афокусеиҿкаараан  иалкаатәуп	Выделять при фокусировании
Афаилтә операциақәа арбатәуп	Показать файловые операции
Акаталогқәеи афаил ҿыцқәеи архив иацҵатәуп	Добавить в архив новые файлы и каталоги
Уажәти аусуратә ҭыԥ аԥенџьырқәа арбалатәуп	показывать окна текущего рабочего места
Уажәтәи адокумент азы астатистикатә информациа аарԥштәуп	Выдать статистическую информацию о текущем документе
Аусуратә еишәақәа рыхьӡқәа 	Наименования рабочих мест
Адаԥа аҳәаа адәахьтәи аԥшра	Внешний вид границы рамки
Анапхгара ахәҭа аҩныҵҟа аҭагалара афокус аиндикатор асахьа ҭыхтәума	Рисовать ли индикатор фокуса ввода внутри элементов управления
Иалкаау аҭаӡқәа рзы агәылаҵақәа аԥҵатәуп	Создать закладки для выделенных папок
Аелемент ҩынтәи ақәсрала активтәра азура	активировать элементы двойным щелчком
Атема, афаилқәа рдыргаҷақәа раарԥшразы ахархәара зызу	Тема, используемая для отображения значков файлов
Агха иахырҟьана иаанкылоуп	Остановлено из-за ошибки
Иахьымнеиц азхьарԥш аԥштәы	Цвет непосещённой ссылки
 Ахәҭа ԥшаатәуп акәалаԥ : ахь иацҵазарц	Найти элемент для добавления в ящик:
Ақәыԥшылара апиксельқәа абзацқәа рыҵаҟа	Пикселей в пространстве под абзацами
Ари ацаԥха шьақәыргылазар, аҵаҩымҭақәа анҵахоит адыргаҷақәа аганахь ала,хьыхьала акәымкәа.	Если этот ключ установлен, подписи будут размещены сбоку от значков, а не под ними.
Аусуратә ҭыԥк аҟынтәи даҽакахьы аҿакра	Переключение между рабочими местами
Адиректориа аҭаҩраан аилахәара ҟалеит 	Сбой при записи индекса директории 
Ари атег анырра ҟанаҵома ииагоу ацәаҳәақәа ирыбжьаӡо апиксельқәа рхыԥхьаӡара	Влияет ли этот тег на количество пикселей между перенесенными строками
Аусуратә еишәа рыцқьатәуп	Расчистить рабочий стол
Иацҵатәуп ма ианыхтәуп.	Добавить или удалить.
Ахырхага алацәҟәра аласра	Частота мигания курсора
Афаилтә система арныҟәага	Движок файловой системы
Апалитра ахархуара амоума	Используется ли палитра
Абраузер атерминал аҭахуп	Браузеру нужен терминал
Амениу аҟны иҟоуп аихшага	В меню есть разделители
Атекст адыргаҷқәа рааигәа	Текст рядом со значками
Аԥштәқәа рыхсаала аилазаара ахәҭа азы агәынкылара ашара замуит	Не удалось распределить память для элементов карты цветов
Адыргаҷақәа раҳасабала арежим ахәаԥшразы амасштаб ишыҟоу еиԥш.	Масштаб по умолчанию для режима просмотра в виде значков.
Уажааигәа ахархәара змаз адокументқәа	Недавно использовавшиеся документы
Ахархәара змоу афаил алхраан адиалог.	Используемый диалог выбора файлов.
Аҵла асахьа аҭаны излахәаԥшуа амодель	Модель для просмотра в виде дерева
Аамҭалатәи афаил аҟынтә аԥхьараан аилахәара ҟалет	Произошёл сбой при чтении из временного файла
Аиҵаргылара амодель, иара аҟнытә атекст аиураз ахархәара змоу	Модель столбца, используемая для получения из нее текста
Аҭаӡ архив ахь иацҵатәуп	Добавить папку в архив
Автоматикала иҵәахлатәуп	Автоматически скрывать
Авиджет ақәыԥшы иактивуп	Виджет образца активен
Аваратәи апанель арктәуп	Закрыть боковую панель
Иалкаау атом агәылхтәуп 	Извлечь выделенный том
Арӷьарахьтәи ирҭбаау агантәи апанель	Правая расширенная краевая панель
Аус аруга апытҟәыр ахьӡ шьақәыргылам	Имя кнопки запуска не установлено
Афаилтә менеџьер аҟны афаилтә система алаԥшхгара	Просмотр файловой системы в менеджере файлов
Ари аҭаӡ ахҳәааҟаҵагаҿ фаил аԥенџьыраҿ иаарттәуп	Открыть эту папку в окне обозревателя файлов
Шьҭахьҟалатәи алԥшаара аԥенџьыр ҿыцқәа рзы ахархәара азутәуп	Использовать обратный порядок сортировки для новых окон
Амаругақәа рпанель апытҟәыр иаакәыршаны анаашьа	Тип скоса вокруг кнопок панели инструментов
Амаругақәа рпанель асахьа шԥаҭыхтәу	Как рисовать панель инструментов
Аҭагылазаашьа ацклаԥшра	Отслеживать состояние
Афаил аныԥсахыз арыцхә.	Дата изменения файла.
Афаил афон ахьӡ аганахьтәи апанель ишыҟоу еиԥш	Имя файла фона боковой панели по умолчанию
Уажааигәа ахархәара змаз адокумент рыхьӡынҵа рыцқьатәума?	Очистить список недавно использовавшихся документов?
Асааҭ апплет аҿы арыцхә арбалатәуп	Показывать дату в апплете часов
Аханатәтәи аусуратә ҭыԥаҿ еиҭашьақәыргылатәуп	восстанавливать на исходное рабочее место
Иаҿыгоу ахәҭақәа агәылаҵақәа ханарҭәаауама аҵакыра зегьы	Заполняют ли вкладки дочернего элемента всю область
Араҟа адҵатә цәаҳәа  ҭагалатәуп. 	Ввести здесь командную строку.
Ашәагаа аҽызлаԥсахуа акәакь амоуп	Имеет уголок изменения размера
Амениу арбара 'Аҭагалашьа аметод'	Показывать меню 'Методы ввода'
Апринтер аҭагылазаашьа ашьклаԥшра	Следить за состоянием принтера
Адинамикала зыҽҭазгало амодульқәа	Динамически загружаемые модули
Уажәтәи адокумент аҟны аорфографиа гәаҭатәуп	Проверить орфографию в текущем документе
Уажәтәи аусуратә еишәаҿы еиҭашьақәыргылатәуп	восстанавливать на текущее рабочее место
Атерминал акодзура ма иацҵатәуп ма ианыхтәуп	Добавить или удалить кодировки терминала
Апрограммақәа реиԥш афаил анагӡара ақәиҭтәра	Позволять выполнение файла как программы
Иҭажәгалар мамзаргьы иара ахь азхьарԥш аԥҵара шәылшоит.	Вы можете закачать его или создать ссылку на него.
Акадрқәа рхыԥхьаӡара анимациаҿы:	Количество кадров в анимации:
Асимволқәа ркодқәа ықәыргылатәуп	Установить кодировку символов
Апытҟәыр аиагаратә аҭагылазаашьа	Состояние переключения кнопки
Даҽа программак аҿы иаарттәуп.	Открыть в другой программе.
Авиджет аҵакыра иахьынӡазалху аҟынӡа аиҵаргылақәа рыҽдырҭбаауеит	Столбцы расширяются до размеров выделенной виджету области
Иҵәаху апанель аҟны иаарԥшхо апиксельқәа рхыԥхьаӡара.	Количество отображаемых пикселов скрытой панели.
Афаил иазку аинформациа аиура залмыршахеит	Не удалось получить информацию о файле
Афаилқәа рыхьӡынҵа афаилқәа акаталог аҿы аҭыԥ ала иеилыԥшаатәуп	Сортировать список файлов по каталогу расположения файлов
 Арӷьарахьтәи агәҭантәи апанель	Правая центрированная панель
Адыргаҷқәа рмасштаб ишыҟоу еиԥш	Масштаб значков по умолчанию
Ахьӡынҵақәа раҳасабала арежим ахәаԥшразы амасштаб ишыҟоу еиԥш.	Масштаб по умолчанию для режима просмотра в виде списка.
Аиагага-апытҟәыр асахьа ҭыхтәуп арадио-пытҟәыр еиԥш	Рисовать кнопку-переключатель как радио-кнопку
Ақәыԥшылара , анапхгара ахәҭа иацырҵо анапхгара арӷьарах ала.	Пространство, добавляемое к элементу управления справа.
Мениуҵас апанель ахь иацҵатәуп	Добавить как меню на панель
Апринтер азы акьыԥхь аилазаара	Система печати для принтера
Акьыԥхьра аилазаара ишыҟоу ала	Система печати по умолчанию
Аусурҭатә еишәа афон еиҭактәуп	Изменить фон рабочего стола
Апиксельқәа акәыԥшылараҿы абзацқәа рханы	Пикселей в пространстве над абзацами
Агәыларатә еиҵаргылақәа рыбжьара ибжьаӡо	Расстояние между соседними столбцами
Акаҵкәыр арыцқьаразы аҽазыҟаҵара цоит.	Идёт подготовка к очистке корзины.
Атекст зегьы алкаатәуп атексттә ҭыԥ аҟны	Выделить весь текст в текстовом поле
Арӷьарахь ацәаҳәа аҭагылазаашьа аарԥшра ақәнагоума	Следует ли отображать строку состояния справа
 Аутентификациаҿы аиԥҟьара ҟалеит. Анбанқәа ҭагалазар ауп ииашоу арегистр аҟны.	 Сбой аутентификации.  Буквы должны быть введены в правильном регистре.
Аԥенџьыр аарԥштәуп, аусуратҿ еишәаҿы шәџьоуҳар мамзаргьы афон аԥштәы ашьақәыргылара шәақәиҭызтәуа 	Показать окно, которое позволит вам установить ваш орнамент или цвет фона рабочего стола
Адиск ахь афаилқәа реиқәырхара аҿыхтәуп	Отключить сохранение файлов на диск
Амаругақәа рпанель аҿы ишыҟоу ала иаанхома атекст мацара, атексти адыргаҷақәеи,адыргаҷақәа рымацара уб. иҵ.	Будет ли на панели инструментов по умолчанию только текст, текст и значки, только значки и т. д.
Арадио-пытҟәыр ма апытҟәыр-бираҟ аиндикатор акәша-мыкуша ақәыԥшылара	Пространство вокруг индикатора кнопки-флажка или радио-кнопки
 Ашьақәырӷәӷәара иадҵаалатәуп акаҵкәыр арыцқьареи афаилқәа раԥыхреи 	Запрашивать подтверждение очистки корзины или удаление файлов
Иаарту афаилқәа зегьы арктәуп	Закрыть все открытые файлы
Ашрифт амасштаб шьақәыргылоуп	Масштаба шрифта установлен
Ашрифт авариант шьақәыргылоуп	Варианта шрифта установлен
Уажааигәа ахархәара змаз адокументқәа рыцқьатәуп	Очистить недавно использовавшиеся документы
Апытҟәырқәа еиҵаӡоу рргылара аконтеинер аҩныҵҟа 	Минимальная высота кнопок внутри контейнера
Апытҟәырқәа еиҵаӡоу рыҭбаара аконтеинер аҩныҵҟа 	Минимальная ширина кнопок внутри контейнера
Аԥенџьырқәа зегь реикәаԥсареи аусурҭатә еишәа арыцқьарази абраҟа шәақәыӷәӷәа	Щёлкните здесь для сворачивания всех окон и расчистки рабочего стола
Ари атег абзацқәа реиҟаратәраан анырра ҟанаҵома	Влияет ли этот тег на выравнивание абзацев
Иалкаау атекст агәылаԥҟатәуп	Вырезать выделенный текст
Аобект апозициа апанель аҟны	Позиция объекта на панели
Ашрифт ашәагаа шьақәыргылоуп	Размера шрифта установлен
Ацәаҳәа хыхь арастр акуаԥқәа	Точек растра над строками
Афаил ахь азхьарԥш аԥҵахоит:	Создаётся ссылка на файл:
Ацҳамҭа адиалогатә тексти апытҟәырқәеи рыбжьара ибжьаргылатәума аиҟәыҭхага	Помещать ли разделитель между текстом и кнопками диалога сообщений
Юникод анапхга аҭагалара асимвол бжьаргылатәуп	Вставить управляющий символ набора Юникод
Аелементқәа зегьы уажааигәа ахархәара змаз адокументқәа рҿы ирыцқьатәума?	Очистить все элементы списка недавно использовавшихся документов?
Ацәаратә режим ахь ииастәуп	Перевести в спящий режим
Аҵаҵеиԥш ахархәара аҭатәуп 	Располагать в виде обоев
Афаил аҟны адыррақәа мыцхуп	Данные в файле избыточны
Аҟаҵарақәа ргәыԥ азы ахьыӡ.	Имя для группы действия.
Аԥхьатәи аплан шьақыргылоуп	Передний план установлен
Апараграф афон аԥштәы ахьыӡ	Имя цвета фона параграфа
Афаил ахь азхьарԥш аԥҵахоит	Создаётся ссылка на файл
Афаил мамзаргьы адрес аԥшаара амуит.	Не удаётся найти файл или адрес.
аҭагылазаашьа ацәаҳәа иамоума акәакь аԥенџьыр ашәагаа аԥсахраз	имеет ли строка состояния уголок изменения размера окна
Уажәтәи арыцхәи аамҭеи ахырхага апозициа иҭаргылатәуп	Вставить текущую дату и время в позиции курсора
Истандарту апытҟәыр иарбалатәуп ахыц ашьҭахьҟа ирханы	Отображать стандартную кнопку со стрелкой назад
Еиқәырхоу аԥшаара аредакциа азутәуп	Редактировать сохраненный поиск
 Ишыҟоу еиԥшишьақәыргылоуп	Установить по умолчанию
Аус арура апытҟәыр аҟазшьа	Свойства кнопки запуска
Ахатәы аагарҭақәа арбатәуп	Показать личные ресурсы
Астандартә фон ыргьежьтәуп	Вернуть стандартный фон
Иалкаау елементцыԥхьаӡа аԥенџьер ҿыц аҿы иаартлатәуп	Открыть каждый выделенный элемент в новом окне
Адыргақәа ацәаҳәақәа рҿы ианыԥсахыз арыцхә ала еилыԥшааны еиқәрхатәуп	Сохранять значки отсортированными по дате изменения в строках
Амаругақәа рпанель иаакәыршаны аҿҟьа астиль	Стиль скоса вокруг панели инструментов
Адыргаҷа ашәагаа аҷыдаҟазшьа шьақәыргылоума	Установлено ли свойство размера значка
Адыргаҷақәа акаҭала еиҟаратәны еиқәырхатәуп	Сохранить значки выровненными по сетке
Ахы аиҭаҭаҩҩраан аилахәара ҟалеит 	Сбой при перезаписи заголовка 
Иагәҭасны иҟоума аиҭагага-апытҟәыр	Нажата ли кнопка-переключатель
Ацкарқәа реиҟаратәра шьақәыргылоуп	Выравнивание краёв установлено
Аԥшьқәа рԥенџьыркәа зегь еикәаԥсаны аусурҭа еишәа арбатәуп 	Свернуть все окна приложений и показать рабочий стол
Аиҵаргылақәа рыхқәа апытҟәырқәа арбалатәуп	Показывать кнопки заголовков столбцов
Адәахьтәи аминиатиуртәгақәа зегьы аҿыхтәуп	Отключить все внешние миниатюризаторы
Афон аԥштәы аганахьтәи апанель ишыҟоу еиԥш	Цвет фона боковой панели по умолчанию
Адокумент зегьы алкаатәуп	Выделить весь документ
Апшь атерминал аҟны иҟоуп	Приложение в терминале
Ҵәҩанҵәылатәи ахышәаракәа	Вертикальные параметры
Агәыԥ аԥсахра аҟәыхтәума?	Отменить смену группы?
 Апанель ахала ааартра аанкылара 	Задержка автораскрытия панели
Аекран Ахьчаҩ активизациа азутәуп	Активировать Хранитель экрана
Арыдыркыратә быкь бжьы афаил ахьӡ	Имя файла клавиатурного гудка
Ҵәанҵәылатәи апанельқәа рҿы иаарҳәлатәуп 	Поворачивать на вертикальных панелях
Ахырхага лассы-лассы алацәҟәра аура миллисекундла	Длина цикла мигания курсора в миллисекундах
Амшқәа рыхьыӡ арбалатәуп	Показывать имена дней
Афаилтә дыргаҷақәа ртема	Тема файловых значков
Аминиатиурақәа раарԥшра:	Показывать миниатюры:
Анапхгара зуа апытҟәыр ақәықшара	Щелчок по управляющей кнопке
Афаилқәа рырхиарақәеи рнапхгареи	Настройки управления файлами
Ҳаҭамыз, аха инацәыхаро аиқәҳәаларҭа аҟынтәи акоманда анагӡара шәылшом.	Извините, но вы не можете выполнять команды с удаленного узла.
Адыргаҷақәа ацәаҳәақәа рҿы аемблема ала еилыԥшааны еиқәырхатәуп	Сохранять значки отсортированными по эмблемам в строках
Азыԥшра арежим ахь акомпиутер ииагатәуп	Перевести компьютер в ждущий режим
Агәылаҵақәа иеиҟароу ашәаагақәа рымоума	Имеют ли вкладки одинаковый размер
Абраузер иеилнакаауеит инахароу адҵақәа	Браузер понимает удалённые команды
Кәалаԥҵас апанель ахь иацҵатәуп	Добавить как ящик на панель
Имаксималу ацәаҳәалдага ашәагаа	Максимальный размер линейки
Авиджет аҭагалара афокус амоума	Имеет ли виджет фокус ввода
Аԥхьа иҟаз аиқәшәарақәа ҳаԥшаап	Найти предыдущее совпадение
Амениу апанель ашәшьыреи амениу ахәҭақәеи рыбжьара ақәыԥшылара	Пространство между тенью панели меню и элементами меню
Адыргаҷақәа ацәаҳәақәа рҿы изаҟаро ала еилыԥшааны еиқәырхатәуп	Сохранять значки отсортированными по размеру в строках
Аҩбатәи ахырхага аԥштәы	Цвет второго курсора
Апанель аобиект ҳгәыҳҽанӡамкәа аус хнаркәшеит 	Объект панели неожиданно завершил работу
Ихыло аҵаҳәара акәалаԥ азы мазаргьы амениу азы	Всплывающая подсказка для ящика или меню
Иақәнагоума аконтексттә мениу атекст аҭагалара аелементқәа аметод аԥсахра адгалара аҭагалара	Должны ли контекстные меню элементов ввода текста предлагать сменить метод ввода
Ажәпацәамкәа атекст азин аҭара	Разрешать полужирный текст
Аиндикатор иаакәыршаны ибжьаӡо	Интервал вокруг индикатора
Адыргаҷа, аоабиект апытҟәырҵас ахархәара змоу	Значок, используемый для кнопки объекта
Шәара иашаны ишәҭахума аҭоурых шәхашәыршҭырц?	Вы действительно хотите забыть историю?
Аобиект апытҟәыр азы даҽа дыргаҷак ахархәара аҭатәуп	Использовать другой значок для кнопки объекта
Афаил ахь аҵыхәтәантәи анеира арыцхә.	Дата последнего доступа к файлу.
Адыргаҷақәа ацәаҳәақәа рҿы атип ала еилыԥшааны еиқәырхатәуп	Сохранять значки отсортированными по типу в строках
Иақәнагоума аконтексттә мениу атекст аҭагалара аелементқәа иадыргаларц аҭаргылара анапхгаратә символқәа	Должны ли контекстные меню элементов ввода текста предлагать вставить управляющие символы
Ахыцқәа арбалатәуп аҵәахратә пытҟәырқәа рҿы 	Показывать стрелки на кнопках сокрытия
Ари атег ашрифтқәа рҭаацәара анырра азнауама	Влияет ли этот тэг на семейство шрифта
Аԥенџьыр ҿыцқәа рҿы адрес аҭагалара цәаҳәа арбатәуп	Показывать строку ввода адреса в новых окнах
Аԥенџьыр ҿыцқәа рыҟны амыругақәа рпанель арбалатәуп	Показывать панель инструментов в новых окнах
Аимдаратә буфер бжьаргылатәуп	Вставить из буфера обмена
Арегисирахь еиҳа иацәанырраны	Чувствительный к регистру
Хазы иҟоу аиндикациа аблокқәа	Отдельные блоки индикации
Ацәаҳәа аҵаҟа арастр акуаԥқәа	Точек растра под строками
Ацәаҳәа ахарҭәаара  аиҵаргыла	Столбец заполнения строки
Даҽа шрифтк ахархәара азутәуп	Использовать другой шрифт
Астиль атрибутқәа рыхьӡынҵа, атекст ахҵараҿ ахархәара змоу	Список атрибутов стиля, применяемых к тексту метки
Амениҩ ацәаҳәа арбатәуа ма иҵәахтәуп	Показать или скрыть строку меню
Апрограмма адокументациа авторцәа рыхьӡынҵа	Список авторов документации программы
Аелемт аԥшаараа ҳасаб азнауама анбанқәа ррегистр ахьӡынҵа	Учитывает ли поиск элемента в списке регистр букв
Азыԥшратә режим ахь ииастәуп	Перевести в ждущий режим
Егьырҭ аҭаӡқәа иргәылаԥштәуп	Просмотреть другие папки
Апараграф афон шьақәыргылоуп	Фон параграфа установлен
Амчыбжь аномерқәа арбалатәуп	Показывать номера недель
Ацәаблақәа рҭаӡ ахь ииастәуп	Перейти в папку шаблонов
Асимволқәа рыҟны имаксималу аҭбаара	Максимальная ширина в символах
Арбага аҭагылазаашьа ашьақәыргылара	Определять положение указателя
Амчыбжьқәа рномерқәа амзар аҿы иарбалатәуп	Показывать номера недель в календаре
Абираҟ-апытҟәыр ма арадио-пытҟәыр  аиндикатор ашәагаа ма	Размер индикатора кнопки-флажка или радио-кнопки
Иақәнагоума алагылазаара аусурҭа еишәа ҭнахлартә	Должна ли среда отрисовывать рабочий стол
аелемент зныктәи ақәсра ала активтә азура	активировать элементы одним щелчком
Ҳаҭамыз, аха ихадоу ажәа аемблемаҿ иаанарԥшуазар ҟалоит анбанқәа, абжьажьи арыцхәқәеи рымацара.	Извините, но ключевые слова эмблемы могут содержать только буквы, пробел и цифры.
Иеизаку ахьӡынҵа арбалатәуп	Показывать общий список
Акомпиутер аиҭаҿакра аҭахуп	Перезагрузить компьютер
Еиҩшам ацәаҳақәа рзы аԥштәы	Цвет для нечётных рядов
Ашрифт астиль шьақәыргылоуп	Стиль шрифта установлен
Анаскьагага ацәаҳәа аҭбаара	Ширина полосы прокрутки
Иалкаау атекст аԥсахра абуфер ахь игәылаԥҟатәуп	Вырезать выделенный текст в буфер обмена
Изаамҭанытәиу аҭаӡ азы агәылаҵа аԥҵатәуп	Создать закладку для текущей папки
Ашрифтқәа рҭаацәара шьақәыргылоуп	Семейство шрифта установлено
Алаԥшхгаратә параметрқәа аԥыхҭәуп	Сбросить параметры просмотра
Еснагь ахархәара азутәуп адрес аҭагалара апанель мҩа аҭыԥан	Всегда использовать ввод адреса вместо панели пути
Уажәтәи афаил еиқәырхатәуп	Сохранить текущий файл
Хыхьтәи аганахьтәи апанель	Верхняя краевая панель
Ацәаҳәалдага хыхьтәи аҳәаа	Верхний предел линейки
 Аус ацашьа узырбо аиндикатор аҿы атекс	Текст на индикаторе хода процесса
Афаилқәа рыхьӡынҵа афаилқәа рышәагаала иеилыԥшаатәуп	Сортировать список файлов по размерам файлов
Ахьаҵ аҭбаара апытҟәыр иаакәыршаны аҵаҟа адиалог аҿы	Ширина отступа вокруг кнопки снизу в диалоге
Аԥенџьырқәа рыхьӡынҵақәа зегьы мениуҵас иунарбоит иагьулнаршоит дара-дара рыбжьара аиҭаҵра.	Отображает список всех окон в виде меню и позволяет переключаться между ними.
Апанель апплетқәа ридентификаторқәа рыхьӡынҵа	Список идентификаторов апплетов панели
Зыҽзырҭбаауа аобиектқәа рҿы ахьаҵқәа ҟанаҵоит	Создает отступы в расширяемых объектах
Ацәаҳәа аҭагылазаашьа арбалатәуп	Показывать строку состояния
Иалкаау атекст акопиа ақәҭыхтәуп	Копировать выделенный текст
Ахьаҵраз адыргаҷақәа ртема ахьыӡ	Имя темы значков для отката
Ахьӡынҵақәа рмасштаб ишыҟоу еиԥш	Масштаб списка по умолчанию
Ари атег ацәаҳәақәа рхыхь апиксельқәа рхыԥхьаӡара анырра анаҭома	Влияет ли этот тег на количество пикселей над строками
Авиджет апыткәыр аҭбаара иақҿнагоу, асимволқәа рҿы.	Желаемая ширина виджета кнопки, в символах.
Арыӷьарахь ала ахьаҵ аҭбаара пиксельла	Ширина отступа справа в пикселях
Ари аԥенџьыр азы адыргаҷа	Значок для этого окна
Ацәаҳәа ахыхь апиксельқәа	Пикселей над строками
Ацәаҳәа аҵаҟа апиксельқәа	Пикселей под строками
Арелиефтә ҳәаақәаа астиль	Стиль рельефа границы
Аиҵаргыла ахарҭәаараз аиҵаргыла	Столбец заполнения столбца
Арадио-елемент еиԥш асахьаҭыхра	Рисовать как радио-элемент
Алаԥшхгара адыргаҷақәа реиԥш  Алаԥшхгара ахьӡынҵа еиԥш 	Просмотр в виде значков Просмотр в виде списка
Аԥштәы еиқәырхатәуп абра	Сохранить цвет здесь
Акаҭа ацахәақәа аҿактәуп	Включить линии сетки
Ацәаҳәабжьатәи абжьаӡара	Межстрочный интервал
Аҵыхәтәантәи аԥсахрақәа:	Последние изменения:
Аҭагаларааметодқәа ихархәатәуп	Использовать методы ввода
Адыргаҷа ашәагаа шьақәыргылоуп	Размера значка установлен
Ахәаԥшразы амодель адыргаҷақәа рсахьа змоу	Модель для просмотра в виде значков
Ишьаҭынраку акаталог ахыртлара ашьҭахь иаарттәуп	Открыть целевой каталог после распаковки
Апроцесс амҩаԥгара шымҩаԥысуа анубааларатә иҟалоума атекст асахьа аҭаны	Будет ли ход выполнения процесса отображаться в виде текста
Амыругақәа рпанель уажәзтәи аԥенџьыр аҟны иарбатәуп ма иԥхьактәуп	Показать или скрыть панель инструментов в текущем окне
Ишиашоу аекран аҟынӡа изланеиуа арежим аҿактәуп	Включить режим прямого доступа к экрану
Апанель аидентификаторқәа рыхьӡынҵа	Список идентификаторов панели
Уажәҭәи архив еиҭа иаԥхьатәуп	Перечитать текущий архив
Архив аҷыдаҟазшьақәа арбатәуп	Показать свойства архива
Адыргаҷ агылара ноль иаҟароуп	Высота значка равна нулю
Адыргаҷ аҭбаара ноль иаҟароуп	Ширина значка равна нулю
Апрограмма авторцәа рыхьӡынҵа	Список авторов программы
Афаилқәа рахь азхьарԥш аԥҵара	Создание ссылок на файлы
Ари аус азыруа апытҟәыр аусуратә еишәахьы иацҵатәума	Добавить эту кнопку запуска на рабочий стол
Алакар ахҵаракәа рыҵаҟа	Желобок под метками
Аобиектқәа рпанель аидентификаторқәа рыхьӡынҵа	Список идентификаторов объектов панели
Ари аԥенџьыр атема аҟнытә адыргаҷа ахьыӡ	Имя значка из темы для этого окна
Арӷьеи армеи апытҟәырқәа рҭыԥқәа ԥсахтәуп арма напы аҵаҟа иҟоу аҳәынаԥ азы	Менять местами правую и левую кнопки для мышей под левую руку
Иаарту афаилқәа зегьы еиқәырхатәуп	Сохранить все открытые файлы
Аусуратә еишәақәа зегь аарԥшлатәуп	Отображать все рабочие места
 Аус аруратә адыргаҷа ҿыц аԥҵатәуп	Создать новый значок запуска
Аиҵаргылақәа рыхьӡынҵа ишыҟоу еиԥш	Список столбцов по умолчанию
Аҭаӡқәа афаилқәа раԥхьа иҟаҵатәуп 	Помещать папки перед файлами
Ахархәара амоума иальтернативатәу апытҟәырқәа реиҿкаашьа адиалог аҿы	Используется ли альтернативный порядок кнопок в диалогах
 Арӷьарахьтәи иӡысо апанель 	Правая плавающая панель
Алаԥшхгаратә режим: Ахьӡынҵа	Режим просмотра: Список
Уажәтәи аԥшаара афаил еиԥш еиқәырхатәуп	Сохранить текущий поиск как файл
Уажәтәи аԥенџьыр ацәаҳәа аҭагылазаашьа арбатәуп ма иԥхьактәуп	Показать или скрыть строку состояния текущего окна
Аԥенџьырқәа реиҭашьақәыргылараан еиҭагалатәуп уажәтәи аусуратә еишәахьы 	Перемещать окна на текущее рабочее место при восстановлении
Аус аруга апытҟәыр аԥшьқәа рмениу аҟынтәи акопиа ахыхра	Скопировать кнопку запуска из меню приложений
Аиҵаргылақәа реишьҭаргылашьа ишыҟоу еиԥш ахьӡынҵа аҳасабала ахәаԥшраан.	Порядок столбцов по умолчанию при просмотре в виде списка.
Аԥенџьыр ҿыцқәа рыҟны аганахьтәи апанель азы аҭбаара ишыҟоу еиԥш.	Ширина по умолчанию для боковой панели в новых окнах.
Аус арура апытҟәыр аԥҵатәуп	Создать кнопку запуска
Аелептизациа ашьақәыргылара	Установка эллиптизации
Аҭагалара аҩныҵҟатәи афокус	Внутренний фокус ввода
 Адокументкәеи, аҭаӡқәеи аҳатә ҭыԥқәеи рҿа анеира азин	Доступ к документам, папкам и сетевым местам
Агәылаца ахҵара иаакәыршаны ахьацра аҭбаара	Ширина отступа вокруг меток вкладки
Адыргаҷа аханатә изаҟараз аиҭашьақәыргылара	Восстановить исходный размер значка
ахҳәааҟаҵагатә ԥенџьыр аарттәуп.	открыть окно обозревателя.
Апплет уажәтәи аконфигурациа аҟынтәи иаԥыхтәума?	Удалить апплет из текущей конфигурации?
Адыргаҷақәа ацәаҳәақәа рҿы рыхьӡқәа рыла еилыԥшааны еиқәырхатәуп	Сохранять значки отсортированными по имени в строках
Афаилқәа рыхьӡынҵа афаилқәа аҵыхәтәантәи рыԥсахрақәа аамҭақәа рыла иеилыԥшаатәуп	Сортировать список файлов по временам последнего изменения файлов
Имаксималу аҵакы иашьашәалан аҟаҵара 	Максимальное значение подгонки
Зныктәи ақәықшарала адыргаҷақәа аартлатәуп	Открывать значки одиночным щелчком
Ҵаҟатәи аганахьтәи апанель	Нижняя краевая панель
Абларҭа афон шьақәыргылоуп	Фон ячейки установлен
Ацәаҳәалдага ҵаҟатәи аҳәаа	Нижний предел линейки
Аганахьтәи апанель аҭбаара	Ширина боковой панели
Анаскьагага иактивны асахьа ҭыхтәуп аҳәынаԥ ала анахараан	Рисовать прокрутку активной при переносе мышью
Асааҭ ашьақәыргылара апрограмма	Программа установки часов
Ахархәара змоу адыргаҷа атема ахьыӡ 	Имя используемой темы значков
Аҳасабтәқәа риагара аҟынтә иҵәахтәуп	Скрыть из переключателя задач
Анкьатәи аусуратә еишәа ахь азхьарԥш	Ссылка на старый рабочий стол
Алаԥшхгаратә арежим: Аусурҭатә аишәа	Режим просмотра: Рабочий стол
Ари апытҟәыр иалнаршоит аԥенџьырқәа зегьы рыҵәахреи аусуратә еишәа арыцқьареи	Эта кнопка позволяет скрыть все окна и расчистить рабочий стол
Ари аус азыруа апытҟәыр апанель ахь иацҵатәума	Добавить эту кнопку запуска на панель
Ацәаҳәақәа иеиԥшым ԥштәыла ашәра азин рыҭатәуп	Разрешить окраску строк в разный цвет
Ахалагаратә  арныҟҿага афаил алхраз адиалог алхраан	Исходный движок для диалога выбора файлов
Ацәаҳәақәа риагара арежим	Режим переноса строк
Ахырхагақәа ртема ашәагаа	Размер темы курсоров
Афаилқәа рыхьӡынҵа мацара	Только список файлов
Аганахьтәи апанель арежим	Режим боковой панели
Ҩынтә ахыкәласра ибжьаӡо аамҭа	Интервал двойного щелчка
Аиҭагага ацәаҳәақәа рыбжьаӡара	Интервал полос прокрутки
Ашьаҿа иашьашәалан аҟаҵараз аиԥшьра	Приращение для шага подгонки
Ашәыгақәа ршәагаа 8-бит змоу арежим аҟны	Размер палитры в 8-битном режиме
Иалкаау аелементқәа зегьы рхынҳәышьа рымамкәа иаԥыхтәуп	Окончательно удалить все выделенные элементы
Апытҟәыр иагәҭасны ианыҟоу, аиҭаҟаҵара аанкылара аамҭа	Время задержки повтора, когда кнопка нажата
Аԥенџьыр ҿыцқәа рҿы аганахьтәи апанель арбалатәуп	Показывать боковую панель в новых окнах
Ари атег афон аџьоуҳарра анырра анаҭома	Влияет ли этот тег на узор фона
Аҵыхәтәантәи аиҭакрақәа ҳархынҳәып	Вернуть последнее изменение
Иубарҭоу аиҵаргылақәа еиҭактәуп.	Изменить видимые столбцы.
Ахыцқәа ескьынгьы иаҿаклатәуп	Всегда включать стрелки
Аиааларала иашьашәало аҟаҵара	Подгонка по горизонтали
Аҟазшьақәа рԥенџьыр аԥҵахоит.	Создается окно свойств.
Аԥшаага акритериақәа аԥыхтәуп	Удалить критерий поиска
Аиқәҳәаларҭа:аҿакырҭа, абжьы асервер аусура ахьаларго	Узел:порт, на котором запущен сервер звука
Акаҭа ацәаҳәақәа аҿырԥшы	Образец линии сетки
Еиҩшам ацәаҳақәа рыԥштәы	Цвет нечётных рядов
Абларҭа аԥштәы афон ари атег ахь анырра ҟанаҵома	Влияет ли этот тег на цвет фона ячейки
Аԥенџьыр ҿыцқәа рыҟны адыргаҷақәа ижәпаны ранҵара ахархәара рзутәуп	Использовать плотное размещение значков в новых окнах
Ҩынтәтәи ахыкәласра ибжьаӡо аамҭа	Расстояние двойного щелчка
Агылара ашьақәыргылараз адҵаалара	Запрос на установку высоты
Ахҵараҿы ашрифт ахархәара аҭатәуп	Использовать шрифт в метке
Аҭбаара ашьакәыргылараз адҵаалара	Запрос на установку ширины
Амениу аҟны ицәырҵуеит адыгаҷақәа	В меню отображаются значки
Ианыхыз еиҭашьақәыргылатәуп 	Восстановить удалённое
Аԥенџьыр алагамҭатә апозициа	Начальная позиция окна
Аԥшаара еиԥш. еиқәырхатәуп	Сохранить поиск как.
Альтернативала апытҟәыркәа реиҿкаашьа	Альтернативный порядок кнопок
Хыхьтәи аҳаракыра иатәу аҭаӡ аарттәуп	Открыть папку верхнего уровня
Агәылаҵа аҭыԥ азыԥшаара	Размещение вкладки
Аемблемақәа аарԥшлатәуп	Показывать эмблемы
Аҵәахратә пытҟәыркәа аарԥшлатәуп	Показывать кнопки скрытия
Аҭагалара афокус ацәаҳәа аҭбаара	Ширина линии фокуса ввода
Аус аруратә апатҟәыр аԥҵатәуп.	Создать кнопку запуска.
Атерминал аҟны ауыс арутәуп	Запустить в терминале
Аҭагалара аметод аҭагылазаашьа ацәахәа астиль	Стиль строки состояния метода ввода
Аҭаӡқәа рҿы ахәҭақәа рхыԥхьаӡара аарԥшлатәуп 	Показывать число элементов в папках
Ари аҭаӡ азы афон аҳасабала ахархәара азутәуп	Использовать как фон для этой папки
Апытҟәырқәа алашара аҵарԥхалатәуп аҳәынаԥ анақәку	Подсвечивать кнопки при наведении мыши
Аҭагалара афокус ацәаҳәа аштрих	Штрих линии фокуса ввода
Афаилқәа рҿаԥхьа аԥенџьырқәа рҿы акаталогқәа арбатәуп	Показывать каталоги перед файлами в окнах
Аиҭагаларҭаҿы апиксельқәа рхыԥхьаӡара, аиагараан армарахь ала аекран аҭагаларҭа аҭыԥ аҿы аҳәаа иамкыз	Количество пикселей поля ввода, вышедших за левую границу экрана при прокрутке
Аԥенџьырқәа рменеджер аҿы апенџьыр адаԥа асахь анубаалома	Отрисовывается ли рамка окна менеджером окон
Атекст адыргаҷақәа рҿы иарбалатәуп:	Показывать текст в значках:
Адыргаҷақәа аханатә изаҟараз еиԥш ашьақәыргылара	Восстановить исходные размеры значков
Армарахьтәи мамзаргьы хыхьтәи аԥштәы аградиент аԥшшәы аҭыхраан, мамзаргьы инеиԥынкылан.	Левый или верхний цвета при отрисовки градиента, или сплошной цвет.
Аԥенџьер ҿыц аҿы иаарттәуп	Открыть в новом окне
Аԥенџьырқәа рыхьӡынҵа иминималу ашәагаа	Минимальный размер списка окон
Ацәаҳәа алагамҭеи иашьҭанеиуа ацәаҳәа алагамҭеи ирыбжьаӡо абаитқәа рхыпхьаӡара	Число байтов между началом строки и началом следующей строки
Акаҵкәыр аҟынтә ахәҭақәа зегьы рыцқьатәума?	Очистить все элементы из корзины?
Аамҭеи арыцхәи шьақәыргылатәуп	Установить дату и время
Апунктқәа рыҟны ашрифт ашәагаа	Размер шрифта в пунктах
Адыргақәа рыԥшра аҭаны аарԥшра	просмотр в виде значков
Алаԥшхгара арежим: Адыргаҷақәа	Режим просмотра: Значки
Аганахьтәи апанель уажәтәи аԥенџьыр аҟны иарбатәуп ма иԥхьактәуп	Показать или скрыть боковую панель в текущем окне
Аԥенџьырқәа рыбжьара анавигациаз апплетқәа рфабрика	Фабрика апплетов навигации между окнами
Атекст ацәаҳәа аҭагылазаашьа иаакәыршаны арнаара астиль	Стиль скоса вокруг текста строки состояния
Аусуратә еишәақәа рыхьӡқәа аарԥшлатәуп	Отображать имена рабочих мест
Еикәаԥсаоу аԥенџьырқәа реиҭашьақәыргыларазы абраҟа шәақәыӷәӷәа 	Щёлкните здесь для восстановления свёрнутых окон
Аҭагылазаашьаз адырраҭара	Сообщение состояния
Афаилқәа рыхьӡынҵа афаилқәа рыхкқәа рыла иеилыԥшаатәуп	Сортировать список файлов по типам файлов
Аԥенџьыр ҿыцқәа рыҟны ацәаҳәа аҭагылазаашьа арбалатәуп	Показывать строку состояния в новых окнах
Аекран зегь иҭаӡо иааныжьтәуп	Оставить во весь экран
Ацәаҳәақәа рынцәамҭа ахәҭақәа	Детали окончания строк
Атекст адыргақәҵақәа рҭаӡҩыра	Таблица ярлыков текста
аԥенџьырқәа  ахаангьы еидыргәыԥлатәым	никогда не группировать окна
Ахәҭақәа зегьы акаҵкәыр аҟынтәи иаԥыхтәуп	Удалить все элементы из корзины
Аԥхьаӡага-апытҟәыр иаакәыршаны арнаара астиль	Стиль скоса вокруг кнопки-счётчика
Анахага апытҟәырқәа аура ҿацәк инаркны егьи аҿацәынӡа	Длина кнопок перемещения от края до края
Адыргаҷакәа ирыхәаԥштәуп	Просмотреть значки
Еиҩшоу ацәаҳәақәа рзы аԥштәы	Цвет для чётных рядов
Аелементқәа еишьҭаргылатәуп:	Выстраивать элементы:
Абитқәа рхыԥхьаӡара ҟьаԥсрак аҿы	Число битов на плоскость
Амениу ацәаҳәа иаакәыршаны ирнаау астиль	Стиль скоса вокруг строки меню
Аусуратә ҭыԥқәа зегьы рԥенџьырқәа арбалатәуп	показывать окна всех рабочих мест
Аиҭныԥсахларатә буфераҿ агәыларгыларазы акагьы ыҟам.	В буфере обмена нет ничего для вставки.
Афаилқәа рыхьӡынҵа афаилқәа рыхьыӡқәа рыла иеилыԥшаатәуп	Сортировать список файлов по именам файлов
Иминималу аҵакы ала иашьашәалан аҟаҵара	Минимальное значение подгонки
Адыргаҷақәа рзы атема ахьаҵразы	Тема значков для отката
Ацәаҳәа аиҟәҟьара аҭагылазаашьа	Состояние линии разрыва
Абжьаргыла ахықәкы ахьӡынҵа	Список целей вставки
Аелеметқәа  шьақәыргылатәуп	Выстраивать элементы

