Аилазааратә гәыԥ архиагақәа	Настройки сообщества
Аилазааратә гәыԥ ацҳамҭақәа	Сообщения сообщества
Анҵамҭақәа ҿыцқәа рацәоума?	Много новых записей?
Атуризми ахәмарра-ччарақәеи	Туризм и развлечения
Аҽаҵаҩҩра аиҭашьақәыргылара	Возобновить подписку
Иаҭахым, ажәамаӡа исоухьеит	Не надо, код получен
Егьырҭ амаҵзурақәа рҟны аԥшаара	Поиск в других сервисах
Ишәыдаҳныҳәалоит иааиуа Ашықәс ҿыц!	С наступающим Новым годом!
Ирку аилазааратә гәыԥқәа рҿы анҵамҭақәа	Записи в закрытых сообществах
Аиҿцәажәаҩцәа мамзаргьы ацҳамҭақәа рыԥшаара	Поиск сообщений или собеседников
Азин змада ари авидео аҿы ажәеиларкка ааныжьра?	Кто может комментировать это видео?
Шәара ишәылшоит аԥкра змам хыԥхьаӡарала авидеофаилқәа реиқәрхара шәдаҟьаҿы.	Вы можете хранить неограниченное количество видеофайлов.
Аԥшьы Шәеилазааратә гәыԥқәа ртауарқәа рахь анеирҭа амоуп	Приложению доступны товары ваших сообществ
Агәылаҵақәа ирҭагалоу аҳасабырба астатус аԥсахра	Изменение статуса отчёта из закладок
Аилазааратә гәыԥ авидеонҵамҭақәа рахь ацҵара	Добавить в видеозаписи Сообщества
Амаҵзура шәҵакырадгьыл аҟны ахархәара амаӡам	Сервис недоступен в вашем регионе
Дарбан сҭоурыхқәа аҭак риҭаларц измоу алшара	Кто может отвечать на мои истории
Аилазааратә гәыԥ авидеонҵамҭа ахә ршьеит	Оценили видеозапись сообщества
Акрызҵазкуа асаламшәҟәқәа шәызнеиӡом	Вам не придут важные письма
Ахәмарра иацҵоуп аилазааратә гәыԥахь	Игра добавлена в сообщество
Ишиашоу ицоу адырраҭарақәа ВКонтакте	Прямые трансляции ВКонтакте
Аилазааратә гәыԥ аҭак ахә ршьеит	Оценили ответ сообщества
Анеирҭа иаҿакӡам уеб-камера аҟны	Нет доступа к веб-камере
Иҟалар зылшоз алахәылацәақыҟаӡам	Нет возможных участников
Аилазааратә гәыԥ ацҳамҭақәа:	Сообщения сообщества:
Аҭауар иқәхоуп аҭиира ҟынтә.	Товар снят с продажи.
Ацҳамҭа аилазааратә гәыԥ рзы	Сообщения сообществам
Иашәырба шәара шәеимадарақәа	Укажите ваши контакты
Ахәмарра анеирҭа амоуп шәықәҿыҭрақәа аҭакқәа рзы рахь	Игре доступны ваши оповещения об ответах
Аномери аԥошьҭеи рышьақәырӷәӷәара	Подтвердить номер и почту
Афильмқәа, амузыка, адырраҭарақәа	Фильмы, музыка, программы
Аҵыхәтәантәи ақәҿыҭрақәа цәыргоуп	Показаны последние ответы
41 123 ҩык ирымоуп азҿлымҳара	Интересно 41 123 людям
Ажәабжьқәа реишьҭагылашьа ҿыц	Новый порядок новостей
Ари ахатә аилазааратә гәыԥоуп	Это частное сообщество
Асахьаҟынтәи ажәамаӡа ҭажәгал	Введите код с картинки
Шәхатәыхьӡи шәмаӡажәеи ҭашәҩа	Введите логин и пароль
Авидеонҵамҭақәа рыхьӡынҵа	Список видеозаписей
Адаҟьа ахыԥхьаӡараҭҵаарҭа	Статистика страницы
Аелеқтроника насгьы аудио	Электроника и аудио
Ажәеиларкка аҳәааҭагалара	Экспорт комментария
Аҭаацәаратә ҭагылазаашьа:	Семейное положение:
Ахьӡынҵа еиқәаҵәа ҭацәуп.	Чёрный список пуст.
Ахьӡынҵеиҭаҳәагахь ацҵара	Добавить в плейлист
Ацҳамҭақәа аҩызцәа рҟынтә	сообщения от друзей
Иалышәха аилазааратә гәыԥ	Выберите сообщество
Иахьа асааҭ 15:00 рзы МСК	Сегодня в 18:00 МСК
Агәыԥ аҿы атемақәа макьана иҟаӡам.	В сообществе пока нет тем.
Араҟа шәыуадаҩра азгәашәҭар алшоит	Опишите проблему подробнее
Сыхьӡынҵеиҭаҳәагақәа рҟнытә аныхра	Удалить из моих плейлистов
Ажәамаӡа қәҿиарала еиқәырхоуп.	Пароль успешно изменён.
Аԥошьҭа аҭыӡҭыԥ шьақәырӷәӷәоуп	Адрес почты подтверждён
Виргинтәи адгьылбжьахақәа, ЕАШ	Виргинские острова, США
Авидеонҵамҭа аилазааратә гәыԥ аҟнытә иныхуп	Видеозапись удалена из сообщества
Аԥшранҵақәа аилазааратә гәыԥ аҭӡамц аҿы	Фотографии на стене сообщества
сҩызцәа зегьы, абарҭ рыда.	всем друзьям, кроме.
Агәынамӡара мап ацәкупнено	Возражение отклонено
Аилазааратә гәыԥ ВКонтакте	Сообщество ВКонтакте
Ақәҿыҭрақәа рахь аҽаҵаҩҩра	Уведомлять о записях
Ақьачақьқәа зегьы раарԥшра	Показать все стикеры
Амаҵзура иазку аинформациа	Информация о сервисе
анеирҭа иарбан аамҭазаалак	доступ в любое время
Анеирҭа иарбан аамҭазаалак	Доступ в любое время
Зегь раԥхьа шәыбжьы шәҭиы!	Проголосуйте первым!
абжьылда аномер абан-бӷьыцаҿ иҟоуп.	номер телефона в бан-листе.
Аилазааратә гәыԥ ацҳамҭақәа рвиџьет	Виджет сообщений сообщества
Аилазааратә гәыԥқәа алахәцәа мацара	Только участники сообщества
Еизыжәга асиужетқәа аҭоурых аҟынтәи	Собирайте сюжеты из историй
Иреиӷьу аҭауарқәа алкааны ишәымаӡам	У вас нет избранных товаров
Аҳәынҭқарра ахадареи аполитикеи	Правительство и политика
Шәыҟаз ВКонтакте ауснагӡақәа рхырхарҭаҿы	Будьте в курсе планов ВКонтакте
Шәара шәеилазаараҿы макьана алацәажәарақәа ыҟаӡам	В вашем сообществе пока нет обсуждений
Аԥсахрақәа аиқәхара иамуит, ԥыҭраамҭак ашьҭахь игәашәҭа ҽазнык.	Не удалось сохранить изменения, попробуйте позже.
Ажәабжьқәа адаҟьақәа рҟынтәи раныхра	Исключать новости от страниц
Араҟа макьана ажәеиларккақәа ыҟаӡам.	Здесь пока нет комментариев.
Ааԥхьарақәа шәҩызцәа рҟынтә	Приглашения от друзей
Аилазааратә гәыԥ ахь ацҵара	Добавить в сообщество
Ашықәс ҿыцтәи агәалаҟазаара	Новогоднее настроение
Аилазааратә гәыԥ аҟынтәи ацҳамҭақәа аиура	Получать сообщения от сообщества
Авакансиа ахь аҭахҳәага азышьҭра	Подать заявку на вакансию
Азҵааранҵа ихадароу ахь ииагоуп.	Опрос помещен на главную.
Аиааира шәгеит,Ишәыдаҳныҳәалоит!	Поздравляем, Вы победили!
Шәҿаҵа аиқәырхараҿы агха ҟалеит.	Ошибка сохранения заказа.
Авиџьет «Аилазааратә гәыԥ ацҳамҭақәа»	Виджет «Сообщения сообщества»
Аилазааратә гәыԥахь ахынҳәра	Вернуться к сообществу
Амодератор ажәеиларкка иҭара	Комментарий модератору
Ахымҩаԥгашьа ашьақәырӷәӷәара	Подтверждение действия
Иазҿлымҳақәо авидеонҵамҭақәа	Популярные видеозаписи
Аԥшьы Шәеилазааратә гәыԥқәа ртауарқәа рахь анеирҭа амазаауеит	Приложению будут доступны товары ваших сообществ
Ауаҩы-бызкаҭаҳа ақалақь ихьчоит ҳәа дҽыжәлеит !	Человек-Паук уже спешит спасти город!
Иван Алексеев ишиашоу ицо атранслиациа далагеит	Иван Алексеев начал прямую трансляцию
Ианышәҵа шәхархәага аҟнытә 6-хыԥхьаӡарак змоу акод уи ашьақәыргыларазы.	Введите 6-значный код из приложения для генерации кодов.
Ажәамаӡа ишәхашҭыма мамзаргьы шәзымҭалаӡои?	Забыли пароль или не можете войти?
Ахархәаҩ макьана имаӡам ахьӡынҵеиҭаҳәагақәа	У пользователя пока нет плейлистов
Шәхатә дыррақәа рахь ахәмарра анеирҭа амазаауеит	Игре будут доступны ваши личные данные
Агәымшәареи аҽазҵәылхреи	Смелость и упорство
Аилазааратә гәыԥ алахәҩы	Участник сообщества
Амузыкарҳәаҩы ахь аиасра	Перейти к музыканту
Анҵамҭа иҭашьақәыргылара	Восстановить запись
Анҵамҭақәа зыгьы рарбара	Показать все записи
анҵамҭақәа рахь ахынҳәра	вернуться к записям
Арлахҿыхрақәеи аԥсшьареи	Развлечения и отдых
Аҭаҭын ахара азыҟазаашьа	Отношение к курению
Ацхыраара аҟнытә азҵаара	Вопрос от Поддержки
Аҵыхәтәантәи амчыбжь ала	За последнюю неделю
ВКонтакте ахь аиқәырхара	Сохранить ВКонтакте
Иахьа агәалашәаратә мшуп	Сегодня День Памяти
Шәыҽшьашәықәырӷәӷәахьеит	Вы уже авторизованы
Ахәмарра анеирҭа амоуп аилазааратә гәыԥ анаԥхгара ахь	Игре будет доступно управление сообществом
Аилазааратә гәыԥ аҿы азнагара	Поделиться в сообществе
Аилазааратә гәыԥқәа рнаԥхгара	Управление сообществами
Ахьӡынҵа еиқәаҵәахь архынҳәра	Вернуть в чёрный список
Ахьӡынҵа еиқәаҵәахь аҭагалара	Занести в чёрный список
Иашәырба ажәла мамзаргьы ахьӡ	Введите имя или фамилию
Хаҭалатәи ацҳамҭақәа рымацара	Только личные сообщения
Шәҿаҵа аҟаҵараҿы агха ҟалеит.	Ошибка создания заказа.
Шәыззыӡырҩахьоу рҟнытә аныхра	Удалить из прослушанных
Аилазааратә гәыԥ архиагақәа еиқәырхоуп.	Категории сообщества сохранены.
Ари асаит аҟнытә иарбанзаалак адаҟьа аԥшаара	Искать любые страницы с этого сайта
Агәражәгаҵәҟьоума ишышәҭаху абри шәвидеонҵамҭа аныхра?	Вы точно хотите удалить этот видеоматериал?
Агха ҟалеит ақәыԥшыла ашьаҭа аҟынтә аныхраан.	Ошибка при удалении шаблона из базы.
Аилагарақәа реилазаара агәыԥ ажәабжьқәа рханы	Блок обсуждений над новостями группы
Ааигәа иҟоу анҵамҭақәа рыла аԥшаара	Искать по записям неподалёку
Ишәызку адыррақәа цәахызаауеит	Ваши данные будут скрыты
Абыржәыҵәҟьа аҭак ҟарҵоит	Ответят прямо сейчас
Ажәеиларкка аҭӡамц аҟнытә	Комментарий со стены
Ажәеиларккақәа аҭӡамц аҿы	Комментарии на стене
Аижәлантәқәеи ахьӡылацәеи	Однофамильцы и тёзки
Атемаҿы ацҳамҭақәа ыҟаӡам	В теме нет сообщений
Аҭаҭын ахара азыҟазаашьа:	Отношение к курению:
ахаҭабзиара азы адиреқтор	директор по качеству
Ианышәҵа азхьарԥш аҭыӡҭыԥ	Введите адрес ссылки
Уаанӡатәи анҵамҭақәа рахь	к предыдущим записям
Ари альбомаҟны макьана иҟаӡам аԥшранҵақәа	В этом альбоме ещё нет фотографий
Аилазааратә гәыԥ аԥшранҵа ахә ршьеит	Оценили фотографию сообщества
Шәара шәкамера аҿыхын аимадара ахаҭабзеира ахьылаҟәу иахьҟьаны	Ваша камера выключена из-за плохого качества связи
Агәаларшәара ҿыц аилацәажәараҿы	Новое упоминание в беседе
Аԥсабареи аԥсшьареи ақалақьнхыҵ	Природа и отдых загородом
Ари аҩыза ацыԥха уажәшьҭа иҟоуп	Такой ключ уже существует
Афотоҭыхымҭақәа аредакциа рзура	Редактирование фотографии
Адгаларақәа макьана иҟаӡам	Рекомендаций пока нет
Ажәамаӡа аиҭашьақәыргылара	Восстановление пароля
Ажәамаӡа ииашамкәа иарбоуп	Неверно указан пароль
Азҿлымҳара змоу анҵамҭақәа	Интересные публикации
Аилакра ахыԥхьаӡараҭҵаарҭа	Статистика сообщества
Аиҳабацәа рзы ахыҵхырҭақәа	Материал для взрослых
Ақьачақьқәа реизга аахәара	Купить набор стикеров
Ара макьана аӡәгьы дыҟаӡам	Здесь пока никого нет
Аҭакқәа ажәеиларккақәа рҿы	Ответы в комментариях
Аҭауарқәа рахь ажәеиларкка	Комментарии к товарам
Аҭитәы иманшәаланы иныхуп.	Товар успешно удалён.
Ахархәаҩ ихәмаррақәа зегьы	Все игры пользователя
Иашәырба аилацәажәара ахьӡ	Введите название чата
Иашәырбеит ииашам ажәамаӡа	Вы ввели неверный код
Ихарҭәаау ахьӡынҵа аарԥшра	Открыть полный список
Шәара ишәҩызцәазар рылшоит	Ваши возможные друзья
ВКонтакте ахь шәҭала, аиҿцәажәара шәалагарц азы	Войдите ВКонтакте, чтобы начать диалог
Абыжьқәа шәоурц азы, хыхь ианышҵаа 6-хыԥхьаӡаракла ишьақәгылоу акод.	Чтобы получить голоса, введите этот 6-значный код выше.
Ари ахархәага шәҭалартә еиԥш азин шәымаӡам	Доступ к данному ресурсу ограничен
Аилазааратә гәыԥ аҿы шәҩызцәа ыҟаӡам.	В сообществе нет ваших друзей.
Шәеиҿцәажәаҩ шәааԥхьара мап ацәикеит.	Ваш собеседник отклонил вызов.
Аилазараатә гәыԥ ахьӡынҵа еиқәаҵәа аҟны шәыҟоуп уи азы ишәылшаӡом азҵааранҵаҟны абжьыҭира.	Вы находитесь в чёрном списке сообщества и не можете голосовать в опросе.
Ҳара иаҳҭахуп аҩызцәагьы, однокурсникцәагьы, одноклассникцәагьы, агәылацәагьы, аколлегацәагьы иасымша аимадара рыбжьазарц.	Мы хотим, чтобы друзья, однокурсники, одноклассники, соседи и коллеги всегда оставались в контакте.
Аилакра аҭӡамц аҟны иану анҵамҭа	Запись на стене сообщества
Хаҭалатәи ацҳарақәа рахь анеирҭа	Доступ к личным сообщениям
Шәара шәеилазаараҿы макьана аҭитәқәа ыҟаӡам	В вашем сообществе пока нет товаров
Ажәабжьқәа рҟынтәи аҽаныхра	Отписаться от новостей
Ара алԥшаага макьана иҟаӡам	Здесь ещё нет подборок
Аҿаҵаҩҩра иаԥыхын уи аԥхьа.	Подписка уже отменена.
Украина Атәылахьчаҩцәа рымш	День защитника Украины
Ԥсыхәа амамкәа асессиақәа зегь арктәуп	Необходимо завершить все сессии
Аҵыхәтәантәи азгәаҭақәеи ахьарԥшқәеи аарԥшуп	Показаны последние упоминания ссылки
Сконтактқәа рымацара, абарҭ рыда.	только мои контакты, кроме.
Аилазааратә гәыԥ аиҿкааҩ иԥхьара.	Звать владельца сообщества.
Аилазааратә аилка ацҳамҭақәа рхиагақәа еиқәырхоуп.	Настройки сообщений сообщества сохранены.
Иаарласны ажәамаӡа аиҭашьақәыргылара ахь узынаӡом.	Быстрое восстановление пароля недоступно.
Азҿлымҳара змоу адаҟьақәа зегьы рырбара	Показать все интересные страницы
Аӡыргаратә ақциақәа аиҿкаара	Создать рекламную акцию
Аӡыргараҭаҩ иҟнытә аҭахҳәага	Заявка от рекламодателя
Ахыԥҽыҭрақәеи авиқторинақәеи	Головоломки и викторины
Ахьарԥшга ииашамкәа иарбоуп.	Неверно указана ссылка.
Ашықәс ҿыцтәи адныҳәаларақәа	Новогодние поздравления
Қәҿиарала ианыхын аҭоурыхқәа	Истории успешно удалены
Шәҽаҵашәыҩҩы абарҭ адаҟьақәа рыуакы, иаразнак ишәдырларцазы ВКонтакте аҿыцҭагаларақәеи ауснагӡатәқәеи иамоу ртәы:	Подпишитесь на одну из этих страниц, чтобы сразу узнавать о нововведениях и планах ВКонтакте:
Ажәытә ажәамаӡа ииашамкәан иарбоуп	Старый пароль указан неверно
Асалам шәҟәы аспам еиԥш азгәаҭоуп.	Сообщение помечено как спам.
Аилазааратә гәыԥқәа рахь ааԥхьара сызҭар зылшо	Кто может приглашать меня в сообщества
Аекономикеи афинансқәеи	Экономика и финансы
Аекстремалтә аиндаҭлара	Экстремальный спорт
Аилазааратә гәыԥ адаҟьа	Страница сообщества
Аилазааратә гәыԥ аҭыҵра	Покинуть сообщество
Аилацәажәарахь ааԥхьара	Пригласить в беседу
Аинтерес зҵоу адаҟьақәа	Интересные страницы
Алкаақәа рҟынтә ианыхуп	Удалено из закладок
Анҵамҭа ашьақәырӷәӷәара	Архивировать запись
Анҵамҭақәа зегь аныхуп.	Все записи удалены.
Анҵамҭақәа рхыԥхьаӡара:	Количество записей:
Аԥарашәаратә ашәаԥсанҵа	Платёжная квитанция
Атәылауаҩшәҟәы аԥшранҵа	Фотография паспорта
Аҭалара ашьақәырӷәӷәара	Подтверждение входа
Аҭитәқәа зегьы раарԥшра	Показать все товары
Аҵыхәтәантәи аԥсахрақәа	Последние изменения
ВКонтакте ала ацхыраара	Помощь по ВКонтакте
Еиҳа ахәмаррақәа арбара	Показать больше игр
Иҵегь анҵамҭақәа арбара	Показать ещё записи
Мыцхәы изаатәиуп арыцхә	Слишком ранняя дата
Сахьану авидеонҵамҭақәа	Видеозаписи со мной
Авидеонҵамҭақәа зегьы рырбара	Показать все видеозаписи
Ажәеиларкка еиҭашьақәыргылара	Восстановить комментарий
Ажәеиларкка еиҭашьақәыргылоуп	Комментарий восстановлен
Ажәеиларккақәа зегьы раарԥшра	Показать все комментарии
Аӡыргаратә ақциақәа реиҿкаара	Создание рекламной акции
Альбомқәа зегьы рҟнытә аныхра	Удалить из всех альбомов
Амузеи, агалереа, ацәыргақәҵа	Музей, галерея, выставка
аҩызцәеи аҩызцәа рҩызцәеи рзы	друзьям и друзьям друзей
Иҵегь абжьынҵамҭақәа раарԥшра	Показать ещё аудиозаписи
Ажәабжьқәа адаҟьақәа рҟынтәи арбара	Показывать новости от страниц
Абжьынҵамҭақәа зегьы қәҿиарала иҭагалоуп.	Все аудиозаписи успешно загружены.
Шәыгәлаҵақәа рҿы макьана иҟаӡам аусмҩаԥгатәқәа.	В ваших закладках пока нет мероприятий.
Шәдаҟьа аанкылоуп агәыԥқәа рахь ааԥхьарақәа шаны иахьашьҭуаз азы.	Аккаунт заблокирован за рассылку приглашений в группу.
Ицензурам алексика афильтра иалнакааует ипатудоу ажәақәа, насгьы ианнахоит ахҳәаақәа аилакрақәа рыҭӡамцқәа рҟны иахьану.	Этот фильтр удаляет со стены сообщества комментарии, которые содержат неприличные слова и выражения.
Шәара ииашаҵәҟьаны ишәҭахума шәҩызцәа рабжгьарақәа зегьы рыҵәахра?	Вы действительно хотите скрыть все рекомендации друзей?
Авидео аныхуп альбомқәа зегьы рҟнытә	Видео удалено из всех альбомов
Аԥсахрақәа рыхьӡанҵа англыз бызшәала	Список изменений на английском
Агәылаҵарақәа збо шәхала шәоуп	Закладки видны только вам
Аграффити адәахьтәи асаит аҟны	Граффити на внешнем сайте
азгәаҭақәа рҳәааҭыгара архиара	настроить экспорт заметок
Азгәаҭақәа рҳәааҭыгара архиара	Настроить экспорт заметок
Аиасра адәныҟатәи азхьарԥшлара	Переход по внешней ссылке
Аилазааратә гәыԥ ахь аҽаҵаҩҩра	Подписаться на сообщество
Аудионҵамҭа адырраҭареи ашьҭра	Отправка эпизода подкаста
Аҵәҵәа атранслиациа мҩаԥысуеит	Ведётся трансляция звонка
Аҩыза мамзаргьы ахьӡынҵа алхра	Добавить друга или список
Аветеринартә хәышәтәырҭа	Ветеринарная клиника
Ажәеиларккақәа аҿакқәоуп	Комментарии включены
Аилазааратә гәыԥ аԥшьқәа	Приложения сообществ
Аилазааратә гәыԥ ахҳәаа:	Описание сообщества:
Альбомқәа зегьы раарԥшра	Показать все альбомы
анапаҵаҩҩцәа аилазаараҿы	подписчиков в группе
аԥшрынҵақәа рахь анеирҭа	доступ к фотографиям
Аԥшрынҵақәа рахь анеирҭа	Доступ к фотографиям
Аҭалара ашьақәырӷәӷәара:	Подтверждение входа:
Аҳамҭақәа зегьы раарԥшра	Показать все подарки
Аҳәара иашәҭаз адкылоуп.	Ваша заявка принята.
Ацаԥха аиҭашьақәыргылара	Восстановление ключа
Аҩызцәа рыҭитәқәа заҵәык	Только товары друзей
видеонҵамҭакгьы шәымаӡам	ни одной видеозаписи
ВКонтакте атехнологиақәа	Технологии ВКонтакте
Еиԥшу ахәҭаҷқәа рыԥшаара	Найти похожие статьи
Иҟалап азҿлымҳара амазар	Может быть интересно
Шәтәылауаҩшәҟәы аԥшранҵа	фото вашего паспорта
Адаҟьа аанкылан ари еиԥш аинформациа за аҭагаларҭаҿы «Сара исызкны»:	Аккаунт заблокирован за такую информацию в поле «О себе»:
Ишәыдаҳныҳәалоит! Азхьарԥш аилазааратә гәыԥ адаҟьаҟны иҟалоит.	Поздравляем! Ссылка появится на странице сообщества.
Адыррақәа қәҿиарала идәықәҵоуп!	Данные успешно отправлены!
Иаанкылоуп аилазааратә гәыԥ аҿы	Заблокировано в сообществе
Аилазааратә гәыԥ алахәҩы.	Участника сообщества.
Аилазааратә гәыԥ аԥшранҵа	Фотография сообщества
Акомпиуторқәеи аинтернети	Компьютеры и Интернет
Амаҵзура ианалгаз ашықәс:	Год окончания службы:
Аԥшранҵақәа рҿы адыргақәа	Отметка на фотографии
Артиоми Олеги Ковалиовраа	Артём и Олег Ковалёвы
Ахьӡынҵеиҭаҳәага азнагара	Поделиться плейлистом
Еиԥшу анҵамҭақәа рыҵәахра	Скрыть похожие записи
Альбом аҟны макьана шәаудионҵамҭақәа ыҟаӡам.	В этом альбоме пока нет аудиозаписей.
Аҩызара ахь аҿахәҳәагақәа макьана ишәымаӡам.	У вас пока нет новых заявок в друзья.
Андреи Иаковенко насгьы Елена Савченко	Андрей Яковенко и Елена Савченко
Дарбан сҭоурыхқәа рҭак ҟаҵаны сзаашьҭра змоу алшара	Кто может отправлять мнения к моим историям
Уажәшьҭа алахәцәа азҵааранҵаҿы рыбжьы рҭиир алшоит.	Теперь участники могут голосовать в опросе.
Мыцхәы ирацәоуп абжьқәа. Ԥыҭрак ашьҭахь шәыбжьы шәҭиир шәылшоит.	Слишком много голосов. Попробуйте проголосовать позже.
аӡыргаратә кабинет ахь ахьарԥшга	ссылка на рекламный кабинет
Атранслиациа аҵәҵәа ахь азхьарԥш	Ссылка на трансляцию звонка
Ахәмарра ацҵоуп ахкы Аҿыцқәа ахь	Игра добавлена в блок Новые
Шәара иалшәымхит ишәзааигәоу аҩызцәа, убри аҟынтәи анҵамҭа ҵәаххоит зегьы рзы	Вы не выбрали близких друзей, поэтому запись будет скрыта от всех
Ажәеиларкка азгәаҭоуп аспам еиԥш нас ианыхуп.	Комментарий отмечен как спам и удалён.
Ари ахархәаҩи шәареи ишәымаӡам еицышәзеиԥшу аҩызҵәа.	У вас нет общих друзей с этим пользователем.
Агәыԥ анапхгаҩцәеи аредақторцәеи мацара	Только редакторы и администраторы
Алкаахықәкы рхыԥхьаӡара агәыԥ адаҟьаҟны	Количество тем на странице группы
Аҩызцәа рҳәааҭагалара Одноклассники ала	Импорт друзей через Одноклассники
Агәацԥыҳәарақәа рхыҵхырҭа:	Источники вдохновения:
Ажәеиларккақәа рахь аиасра	Перейти к комментариям
Аилазааратә гәыԥ - аиҿкааҩ	Сообщество-организатор
аилазааратә гәыԥ анаԥхгара	управление сообществом
Акультуратә аусмҩаԥгатәқәа	Культурные мероприятия
Амобилтә абжьылдақәа зегьы	Все мобильные телефоны
Иашәырба шәыбжьылда аномер	Введите номер телефона
Аилазааратә гәыԥқәа рахь ахынҳәра	Вернуться в список сообществ
Егьырҭ аплеилистқәа рҟынтәи алхра	Выбрать из других плейлистов
Иазышьҭоуп ииашам ахашәаҵашәақәа.	Переданы неверные параметры.
ианышәҵа шәашьа ма шәаҳәшьа рыхьӡ	введите имя брата или сестры
Изааныркылои аилазааратә гәыԥқәа?	За что блокируют сообщества?
Астикерқәа рыҵаҳәара аҭагалара ацәаҳәаҿы	Подсказывать стикеры в полях ввода
Ахәмарра шәеилазаарақәа рхыԥхьаӡараҭҵаарҭа абом	Игре доступна статистика ваших сообществ
Ақәҿыҭрақәа рҟынтә аҽаныхра	Не уведомлять о записях
Ахархаҩ иҿахәҳәагақәа зегьы	Все заявки пользователя
Ахьӡанҵа еиқәаҵәала аԥшаара	Поиск по чёрному списку
Ишәыдаҳныҳәалоит! Анҵамҭа аилазааратә гәыԥ адаҟьаҟны иҟалоит.	Поздравляем! Запись появится на странице сообщества.
Ажәеиларкка аспам еиԥш иазгәаҭоуп.	Комментарий отмечен как спам.
Бонаире, Синт-Естатиус насгьы Саба	Бонайре, Синт-Эстатиус и Саба
Шьҭа алимитдатә музыка адунеи аҿы шәыҟоуп!	Теперь вы в мире безлимитной музыки!
Азгәаҭа аиқәырхара насгьы адҳәалара	Сохранить и прикрепить заметку
Аӡыргаратә ҭоурых азҿлымҳара амаӡам	Рекламная история не интересна
Ааԥхьара аилазааратә гәыԥахь	Приглашение в сообщество
Аблог аҟынтәи анҵамҭа ашьҭра	Отправка записи из блога
Авидео альбом аҟнытә ианыхуп	Видео удалено из альбома
Азхьарԥшра қәҿиарала иацҵоуп	Ссылка успешно добавлена
Аӡыргаратә алаҳәарақәа зегьы	Все рекламные объявления
Аԥшранҵа ҿыцқәа сара сахьану	Новые фотографии со мной
Иреиӷьу акомпиутертә хәмарра	Лучшая компьютерная игра
Иҵегь авидеонҵамҭақәа арбара	Показать ещё видеозаписи
Сҵараиурҭа ахьӡынҵаҿы иҟаӡам	Я не могу найти свой вуз
Уажәы аҭел ишәзасуеит аробот 6-хыԥхаьаӡаракла ишьақәгылоу акод шәазҳәо.	На ваш телефон сейчас позвонит робот и сообщит 6-значный код.
Изылшода аҭоурыхқәа рҟны сара исызку адныҳәаларақәа рбара	Кто может видеть поздравления для меня в историях
Агха ҟалеит ажәеиларкка аиҭашьақәыргылараан	Ошибка при восстановлении комментария
Ишәыдаҳныҳәалоит! Авидео қәҿиарала иацҵоуп.	Поздравляем! Видео успешно добавлено.
Шәара ишәҩызцәазар рылшоит ВКонтакте	Ваши возможные друзья ВКонтакте
Аилазааратә гәыԥаҿы акьыԥхьра	Опубликовать в сообществе
Аконсалтинг, абизнес-амаҵзура	Консалтинг, бизнес-услуги
Анҵамҭа ныхуп аԥшаара аҟнытә.	Запись удалена из поиска.
Аԥошьҭатә шәындәыҟәра аԥсахра	Изменение почтового ящика
Ииашам ақалақь ма аҳәынҭқарра	Неверный город или страна
Ишиашо ицо аефир асра аҟаҵара	Создать трансляцию звонка
Изҟынтә аҳәарақәа аҩызара ацҵаразы иааиуа ацҳарақәа	О каких заявках в друзья приходят оповещения
Аиҭаҵ аҟынтә ақәыԥшыла аныхраан агха ҟалеит.	Ошибка при удалении шаблона из движка.
Инарҭбааны ианышәҵа ара ахәшәашьа аԥсыхәқәа.	Подробно опишите здесь способы оплаты.
Агәлаҵа аҟынтәи аныхра	Удалить из закладок
Ажәамаӡа даара иԥсыҽуп	Очень слабый пароль
Ажәамаӡақәа еиқәшәаӡом	Пароли не совпадают
Азхьарԥш ала аиасрақәа	Переходы по ссылкам
Аиҿцәажәарахь ахынҳәра	Вернуться к диалогу
Акод аҿырԥштәы: 059378	Пример кода: 059378
Аԥсахрақәа реиқәырхара	Сохранить изменения
Аԥҵаҩы иҵәахит аҭоурых	Автор скрыл историю
Ари сара сдаҟьа акәӡам	Это не моя страница
Архиагақәа рахь аиасра	Перейти в настройки
Атәылауаҩра ҭаацәароуп	В гражданском браке
Ахәԥса ашәара хыркәшам	Оплата не завершена
Ашықәс ҿыцтәи ажәаҭара	Новогоднее обещание
Иҵегь атарифқәа арбара	Показать ещё тарифы
ҳазҭоу абраузер аҟынтә	с текущего браузера
Ашәҟәы асервер аҟны аиқәырхара залыршахом. Ҳшәыҳәоит шәдаҟьа шәырҿыц, нас ҽазнык шәҽазышәшәа аҭагалара.	Не удалось сохранить файл на сервере. Пожалуйста, обновите страницу и попробуйте ещё раз.
аудит аҳасабеилыргарҭа абухучет аутсорсинг аусеилыргара аделопроизводство абжьгара аконсультациа	аудит бухгалтерия бухучёт аутсорсинг делопроизводство консультирование консультация
Аилазааратә гәыԥ алахәцәа зегьы ирылшоит рыцҳамҭақәа ааныжьра ари атемаҿы.	Все участники сообщества смогут оставлять сообщения в этой теме.
Амаӡажәа аԥсахразы азхьарԥш ажәхьеит.	Ссылка на смену пароля устарела.
Абӷьыц ахь узынаӡам ма ианыхуп	Файл недоступен или удалён
Ажәеиларккақәа рҟнытә аҽаныхра	Отписаться от комментариев
Аилазааратә гәыԥ аҿы аанкылара	Заблокировать в сообществе
Аилацәажәаратә ԥшранҵа аԥсахра	Изменить фотографию беседы
Атехника ақәыргылареи арҽеиреи	Установка и ремонт техники
Ацҳамҭақәа рҭоурых ала аԥшаара	Поиск по истории сообщений
Аҵыхәтәантәи аҭитәқәа раарԥшра	Показать предыдущие товары
Аелектронтә ԥошьҭахь анаӡатҭатә ҭыӡҭыԥ	Доступ к адресу электронной почты
Абжьынҵамҭақәа раарԥшра	Показать аудиозаписи
Абилеҭқәеи аныҟәарақәеи	Билеты и путешествия
Аблогаҿы анҵамҭа ҿыцқәа	Новые записи в блоге
Ажәабжьқәа ахь аиасра »	Перейти к новостям »
Ажәамаӡақәа еиқәшәаӡом.	Пароли не совпадают.
Аибадырреи аиҿцәажәареи	Знакомство и общение
Ақәҿыҭрақәа рырхиагақәа	Настройки оповещений
Ақтивациа азура ахәҭоуп	Необходима активация
Аполит. дунеихәаԥшышьа:	Полит. предпочтения:
Аԥҵаҩ ила ианыхын атема	Тема удалена автором
Аԥҵаҩы иҵәахит аҭоурых.	Автор скрыл историю.
Аԥшранҵақәа реиқәырхара	Сохранить фотографии
атәылауаҩра ҭаацәароуп.	в гражданском браке.
Атранслиациа ахыркәшара	Завершить трансляцию
Аҭоурых аҿы адныҳәалара	Поздравить в истории
Афаил қәҿиарала иныхуп.	Файл успешно удалён.
Ахҭысқәа зегьы раарԥшра	Показать все события
Аҵара ианалагаз ашықәс:	Год начала обучения:
Еиҳау аҵараиурҭа ацҵара	Добавить университет
Ишәыдаагалоу ажәабжьқәа	Предлагаемые новости
Хәажәкыра 8 адныҳәалара	Поздравить с 8 Марта
Шәара ишьақәшәырӷәӷәахьеит шәҭел аномери шәелектронтә ԥошьҭеи.	Вы уже подтвердили номер телефона и электронную почту.
Ари аӡыргара азҿлымҳара амаӡам.	Такая реклама не интересна.
Ахәмарра азин аҭара шәаудионҵамҭақәа рахь анеира	Разрешить игре доступ к вашим аудиозаписям
Ахәмарра азин аҭара шәвидеонҵамҭақәа рахь анеира	Разрешить игре доступ к вашим видеозаписям
Ианышәҵа азхьарԥш изеԥшразаалак ВКонтакте адаҟьа	Введите ссылку на любую страницу ВКонтакте
Аилак аҿы макьана абжьынҵамҭақәа ыҟаӡам.	В сообществе пока нет аудиозаписей.
Архиагақәа қәҿиарала еиқәырхоуп.	Настройки успешно сохранены.
Аҭахҳәага аԥыхра насгьы аҽаныхра	Отменить заявку и отписаться
Ҳшәыҳәоит, иашәырбарц ахцәажәара	Пожалуйста, введите описание
Иашәырба алахәылаҩ ихьӡ.	Введите имя партнёра.
Адаҟьа аиҭашьақәыргылара	Восстановить страницу
Аиҭарҿыцразы абжьгарақәа	Советы по продвижению
Алкаақәа рахь аиагарақәа	Добавления в закладки
Аметро ииашамкәа иарбоуп	Метро указано неверно
Амузыка ацәаныррақәа рзы	Музыка под настроение
Аԥсихологиеи агәабзиареи	Психология и здоровье
Афинансқеи абухгалтериеи	Финансы и бухгалтерия
Ахеидкылақәа, анаплакқәа	Компании, организации
Инарҭбаау ахашәаҵашәақәа	Расширенные параметры
Иреиӷьу амобилтә хәмарра	Лучшая мобильная игра
Сыгәлаҵақәа рахь иацҵара	Сохранить в закладках
Шпицбергенеи Иан Маиенеи	Шпицберген и Ян Майен
Шәара шәзы еиҭашьақәыргылан шәынҵамҭақәа аҭӡамцаҿы, ахарбгалаҩ ила иныхаз шәдаҟьа аҟнытә.	Вам были восстановлены записи на стене, удалённые с вашей страницы взломщиком.
Закәытә хеидкылақәеи азин рымоу исзаарышьҭларц ацҳамҭақәа аҭел аномер ала	Какие компании могут отправлять мне сообщения по номеру телефона
Иахьа имҩаԥысуеит иглобалтәиу ижәларбжьаратәиу акцив «Адунеи Асааҭ», уи инамаркны ВКонтакте насгьы Адунеитә абнатә ԥсабара афонд ааԥхьара ҟарҵоит алашара арцәаразы	Сегодня проводится глобальная международная акция «Час Земли», в ходе которой ВКонтакте и Всемирный фонд дикой природы призывают выключить свет
Ажәамаӡа ԥсахӡам, избан акәзар иҿыцны иҭажәгалаз ажәамаӡа ф-символк иреицуп, цифра мацарала ишьақәыргылоуп, мамзар иақәнагам асимвол амоуп.	Пароль не изменён, так как новый пароль короче шести символов, состоит только из цифр, либо содержит недопустимые символы.
Аицлабра Бразилиатәи ахархәаҩцәа рыбжьара	Конкурс среди пользователей Бразилии
Абраузер иатәу адырраҭара	Браузерные уведомления
Ажәабжьқәа рахь аҽаҵаҩҩра	Подписаться на новости
Ашьақәырӷәӷәаратә ҭыӡҭыԥ:	Адрес для авторизации:
Иашәырба ажәытә ажәамаӡа.	Укажите старый пароль.
Иузааигәоу аҩызцәа ралхра	Выбрать близких друзей
Шаҟа изыԥсоузеи аӡыргара?	Сколько стоит реклама?
Шәҩызцәа рыхьӡынца алышәх	Выберите список друзей
Шәдаҟьа аанкылоуп азин знапы иаку иҟарҵаз азҵаатәхәы ала шәара автортә зинқәа ахьеилажәгаз инамаданы.	Ваша страница заблокирована по запросу правообладателей за нарушение вами авторских прав.
аусмҩаԥгатә ахь ааԥхьара ҟаиҵар илшоит администратор заҵәык	на мероприятие может пригласить только администратор
Шәдаҟьа аанкылоуп абри аҩыза авидео ахьашьҭуаз азы:	Аккаунт заблокирован за отправку таких видео:
Аилазааратә гәыԥ ампыҵакҩы иԥсахра	Изменение владельца сообщества
Аҵыхәтәантәи ахцәажәара арыцхә ала	По дате последнего комментария
Авидео макьана иҭагалаӡам.	Видео ещё не загружено.
Аихауардынқәа рзы атехника	Техника для автомобилей
Аиҿцәажәарахь анеирҭа ԥкуп	Доступ к чату ограничен
Анҵамҭа зегьы рзы иаарԥшуп	Запись открыта для всех
Ари аилазааратә гәыԥ аркуп	Это закрытое сообщество
Атехцхыраара азҵаара аҭара	Задать вопрос Поддержке
Аусмҩаԥгатәқәа рсиа ҭацәуп	Список мероприятий пуст
Еидҳәалақәоу ахархәагақәа:	Привязанные устройства:
Агәаларшәара ҿыц ажәеиларккақәа рҿы	Новое упоминание в комментариях
Аилакра аҭӡамцаҿы анҵамҭақәа ыҟаӡам	На стене сообщества нет записей
Иашәырба абдуцәеи андуцәеи рыхьӡқәа	введите имя дедушки или бабушки
Иашәырба аелектронтә ԥошьҭа аҭыӡҭыԥ	Укажите адрес электронной почты
Избарҭада анҵамҭақәа рыхцәажәарақәа	Кто видит комментарии к записям
Шәдаҟьа аанкылоуп зыгәрагам азхьарԥшқәа ахьаанашьҭуаз азыҳәан:	Аккаунт заблокирован за отправку подозрительной ссылки:
аацҳара сызҭарц алшара змоу	приглашать меня в беседы
Ажәеиларккақәа рхыԥхьаӡара:	Количество комментариев:
Арпатудара злоу ахымҩаԥгара	Оскорбительное поведение
Ахцәажәарақәа аилыҟәшәаара:	Сортировка комментариев:
Иҵегь ажәеиларккақәа арбара	Показать ещё комментарии
Агәыԥтә аиларгара ахьӡынҵа аҟнытә атема ныхуп.	Тема удалена из списка обсуждений группы.
Шәара шәзы еиҭашьақәыргылан шәаудионҵамҭақәа, ахарбгалаҩ ила иныхаз шәдаҟьа аҟнытә.	Вам были восстановлены аудиозаписи, удалённые с вашей страницы взломщиком.
Шәара шәзы еиҭашьақәыргылан шәвидеонҵамҭақәа, ахарбгалаҩ ила иныхаз шәдаҟьа аҟнытә.	Вам были восстановлены видеозаписи, удалённые с вашей страницы взломщиком.
Амаркетингтәи акциа ала ахыԥхьаӡарала	Начисление по маркетинговой акции
Адыррақәа рыԥсахрақәа рԥыхра	Отменить данные изменения
Азеиԥш аинформациахь анеирҭа	Доступ к общей информации
Аилазааратә гәыԥ иԥынгылоуп.	Сообщество заблокировано.
Аиҿцәажәарақәа рсиахь аиасра	Перейти к списку диалогов
Ахьӡанҵашҟа адаҟьа архынҳәра	Вернуть страницу в список
Аҩызцәа рыхьӡынҵахь аиасра »	Перейти к списку друзей »
Иашәырбеит ииашам адыррақәа.	вы ввели неверные данные.
Избарҭада сара сҩызцәеи снапаҵаҩҩцәеи рсиаҟынтә	Кого видно в списке моих друзей и подписок
Виргинтәи адгьылбжьахақәа, Британиатәи	Виргинские острова, Великобритания
Ақәырҷабқәа аԥҵара.	Создание наклеек.
Адаҟьа иманшәаланы еиқәырхоуп	Страница успешно сохранена
Ажәамаӡа иманшәаланы иԥсахуп.	Вы успешно сменили пароль.
Ажәеиларккақәа рахь аҽаҵаҩҩра	Подписаться на комментарии
Аилацәажәара аԥшранҵа арҿыцра	Обновить фотографию беседы
Амобилтә еимадареи аинтернети	Мобильная связь и интернет
Аплан аҿы иарбоу атранслиациа	Запланированная трансляция
Еицышәзеиԥшу аҩызцәа раарԥшра	Показать всех общих друзей
Азҵааранҵа адҳәалара ихадоу адаҟьа аҟны	Закрепить опрос на главной странице
Ақәыԥшыла аныхраан агха ҟалеит	Ошибка при удалении шаблона
Аԥшранҵақәа альбом ахь аиагара	Перенос фотографии в альбом
иашәырба аб мамзаргьы ан рыхьӡ	введите имя отца или матери
Иашәырба аилазааратә гәыԥ ахьӡ	Введите название сообщества
Иашәырба аҩыза ихьӡ.	Введите имя друга.
1.5 мааҭ. инарҭбааны	1.5 руб. подробнее
20 адирам инарҭбааны	20 дирам подробнее
Аиҭагара аҭоурыхи ахашәаҵашәақәеи рырбара	Показать историю и параметры перевода
Ахархәаҩы макьана абжьынҵамҭақәа изанӡым.	У пользователя пока нет аудиозаписей.
Ианышәҵа аилазааратә гәыԥ ахьӡ.	Введите название сообщества.
Ақәыԥшыла аныхраан агха ҟалеит.	Ошибка при удалении шаблона.
Ақьаадқәа рҭагалара акьыԥхьразы	Скачать все файлы для печати
Архиагақәа рҿы ажәамаӡа аԥсахра	Изменить пароль в настройках
Шәара шәеилазаараҿы макьана апатреҭ ыҟаӡам	В вашем сообществе пока нет фотографий
Абжьынҵамҭақәа рыҟәша	раздел Аудиозаписей
Абыжьқәа рхыԥхьаӡара:	Количество голосов:
Агəҽанҵарақәа ыҟаӡам.	Нет предупреждений.
Альбом аҟынтәи аныхра	Удалить из альбомов
Амаркетинги аӡыргареи	Маркетинг и реклама
Анацәеи асабицәеи рзы	Малышам и родителям
Аԥсахрақәа еиқәырхоуп	Изменения сохранены
Аԥсыбзырбагеи арадиои	Радио и телевидение
Аԥшранҵақәа аҭагалара	Загрузка фотографий
Аԥшранҵақәа ахсаалаҿы	Фотографии на карте
Аԥшранҵақәа рыхәаԥшра	Просмотр фотографии
Архиагақәа еиқәырхоуп	Настройки сохранены
Арҿыцра анаӡара амоуп	Доступно обновление
Асахьеи- авидеоҭыхреи	Фото- и видеосъёмка
Аҭыԥқәа, еиҵу абизнес	Места, малый бизнес
Аҳалалреи аԥсыцқьареи	Доброта и честность
Ацҳамҭақәа азин аҭара	Разрешить сообщения
Ашәарҭадареи иҭалареи	Безопасность и вход
Баша аӡәы бзиа данубо	Когда просто любишь
Еиԥшу авидеонҵамҭақәа	Похожие видеозаписи
Иаҿыхқәоу акьачакьқәа	Отключенные стикеры
Ишәыдгалоу анҵамҭақәа	Предложенные записи
Сандрик абга иақәтәоу	Оборотень Александр
Альбом ахь иҭажәгала аԥшранҵақәа	Загрузите фотографии в альбом
Аԥшранҵа иманшәаланы еиқәырхоуп.	Фотография успешно сохранена.
Ашәатәқәа рыхиагақәа еиқәырхоуп.	Настройки платежей сохранены.
Иаанкылоу ахәмаррақәа аҭӡамц аҿы	Заблокированные на стене игры
Шәара иашәырбар ақалақь шәахьынхо, шәҩызцәа	Друзьям будет проще найти и узнать вас,
Шәдаҟьа аанкылан абри аҩыза аԥшранҵа ахьаанашьҭуаз азы:	Аккаунт заблокирован за отправку таких фотографий:
Инарҭбааны ианышәҵа ара азнагашьа аԥсыхәқәа.	Подробно опишите здесь условия доставки.
Адырраҭарақәа рыхҩылаа аҿы арбара	Отображать в ленте уведомлений
Азгәаҭа аныхуп иреиӷьуқәа рҟнытә.	Заметка удалена из избранного.
Альбом аҟнытә авидеонҵамта аныхра	Удалить видеозапись из альбома
Иашәырбаз ажәамаӡақәа еиқәшәаӡом.	Введённые пароли не совпадают.
Абжьынҵамҭа азынашьҭра	Отправка аудиозаписи
Авидеонҵамҭақәа арбара	Показать видеозаписи
Ажәеиларкка адәықәҵара	Отправка комментария
Ажәеиларкка аҭӡамц аҿы	Комментарий на стене
ажәеиларкка еиқәырхоуп	комментарий сохранён
Ажәеиларкка еиқәырхоуп	Комментарий сохранён
Ажәеиларккақәа рырбара	Показать комментарии
Азгәаҭа шьақәырӷәӷәоуп	Отметка подтверждена
Аԥсахрақәа еиқәырхоуп.	Изменения сохранены.
Архиагақәа еиқәырхоуп.	Настройки сохранены.
Астиль, амаҭәа, ашьаҵа	Стиль, одежда, обувь
Атехника, аелектроника	Техника, электроника
Атуризмеи аныҟәарақәеи	Туризм и путешествия
Аҭҵаареи аҭҵаарадырреи	Наука и исследования
Аҩызцәа зегьы раарԥшра	Показать всех друзей
Иҟалаша аусмҩаԥгатәқәа	Грядущие мероприятия
Иҟоуп аҿыҵга ахынҳәраз	Есть повод вернуться
Иҵегь альбомқәа арбара	Показать ещё альбомы
Иҵегь аҳамҭақәа арбара	Показать ещё подарки
Мыцхәы ихьшәоуп арыцхә	Слишком поздняя дата
Шәара ишәзынашьҭоуп ацҳамҭа ашьақәырӷәӷәаратә код змоу, ахә ашәаразы ианышәҵа ишәоуз акод	Вам отправлено сообщение с кодом подтверждения, введите полученный код для оплаты
Ахәмарра азин аҭара шәыԥшранҵақәа рахь анеира	Разрешить игре доступ к вашим фотографиям
Агха ҟалеит ажәеиларкка аныхра аан	Ошибка при удалении комментария
Шәара шәзы еиҭашьақәыргылан шәыԥшранҵақәа, ахарбгалаҩ ила иныхаз шәдаҟьа аҟнытә.	Вам были восстановлены фотографии, удалённые с вашей страницы взломщиком.
Аорганизациақәа ахалхәра, ауаажәларратә ҭыԥқәа	Участие в организациях, общественные посты
Ааигатәи аусмҩаԥгатәқәа	Ближайшие мероприятия
Авидеонҵамҭа ахь аиасра	Перейти к видеозаписи
Аизгақәа зегьы раарԥшра	Показать все подборки
Аилазааратә гәыԥ иԥшаам	Сообщество не найдено
Аҟаҵарбақәа рахь аиасра	Перейти к результатам
Анаҩстәи ажәеиларккақәа	Следующие комментарии
Аԥшранҵақәа рахь аиасра	Перейти к фотографиям
Аҭахҳәага ҿыц аҩызарахь	Новая заявка в друзья
Аусмҩаԥгатәы ахь аиасра	Перейти к мероприятию
Ацҳамҭақәа зегьы рныхра	Удалить все сообщения
Аҵараиурҭатә аиндаҭлара	Университетский спорт
Аҩызцәа рҟынӡа азнагара	Поделиться с друзьями
Даҽа аусура ҭыԥк аҵцара	Добавить место работы
Екваториальнаиа Гвинеиа	Экваториальная Гвинея
Иалышәха акатегориаҟәша	Выберите подкатегорию
Иашәырба ахәмарра ахьыӡ	Введите название игры
Ииасхьоу аусмҩаԥгатәқәа	Прошедшие мероприятия
Иҵегьы аилакқәа аарԥшра	Показать больше групп
Шәҩызцәа ирзеиҭашәҳәеит	Вы рассказали друзьям
Ажәытә аномер ииашаӡамкәан иарбоуп.	Неправильно указан старый номер.
Шәдаҟьа аанкылоуп амодератор ила абри аҩыза аилыркаара азы:	Аккаунт заблокирован модератором с таким комментарием:
Лара уаҳа илылшаӡом ацҳамҭақәагьы шәахь аҩҩра, аҭахҳәагақәагьы ашьҭра аҩызцәа рахь ацҵаразы мамзаргьы шәдаҟьа ахәаԥшра.	Она больше не сможет писать вам личные сообщения, отправлять заявки в друзья или просматривать вашу страницу.
Ари азҵааранҵа уажәшьҭа иарбахоит ихадароу аилак адаҟьа ахь.	Этот опрос теперь выводится на главной страницы группы.
Адокументациа ахь аиасра	Перейти к документации
Аԥошьҭа шьақәырӷәӷәаӡам.	Почта не подтверждена.
Аԥшранҵақәа зегьы ралхра	Выбрать все фотографии
Арадиои аинтернет-радиои	Радио и Интернет-радио
Архиагақәа рахь ахынҳәра	Вернуться к настройкам
Аҭахҳәагақәа еиҳа арбара	Показать больше заявок
Ахьӡынҵеиҭаҳәага аԥсахра	Редактировать плейлист
Ацхрыраагӡақәа рнапхгаҩы	руководитель Поддержки
Ацҳамҭақәа зегьы рырбара	Показать все сообщения
Аҿахәҳәага ахәаԥшра цоит	Заявка рассматривается
Даҽа аккаунт ахь аҭалара	Войти в другой аккаунт
Иашәырба абжьылда аномер	Укажите номер телефона
Уахынлатәи арежим аҿыхра	Выключить ночной режим
Иаҳҳәап: Кьасоу Ҳагба, Хьыбла Мықәба.	Например: Анна Петрова, Ян Иванов.
Шәара шәзы еиҭашьақәыргылан шәҩызцәа, ахарбгалаҩ ила иныхаз шәдаҟьа аҟнытә.	Вам были восстановлены друзья, удалённые с вашей страницы взломщиком.
Аԥшьы анеирҭа амоуп шәықәҿыҭрақәа аҭакқәа рзы рахь	Приложению доступны ваши оповещения об ответах
Аагалыҵ насгьы ахәаахәҭра	Производство и торговля
Аблогаҿы анҵамҭа агәаҭара	Просмотр записи в блоге
Ажәа имыцхәны икьаҿцәоуп.	Слишком короткое слово.
Ажәамаӡа имыцхәны икьаҿуп	Слишком короткий пароль
Аиасра аҭоурых анҵәамҭахь	Перейти в конец истории
Аилкаанҵа аԥшаара амуӡеит	Не удалось найти статьи
Аиҿцәажәаҩ аҭак ҟаиҵаӡом.	Собеседник не отвечает.
Аԥшранҵақәа иҵегь рацҵара	Добавить ещё фотографии
Ацҳамҭа еиҭашьақәыргылоуп	Сообщение восстановлено
Ацыԥха аҭоурых аиқәырхара	Сохранить историю ключа
Шәаҵаҩҩуп ажәабжьқәа рахь	Вы подписаны на новости
Иҭажәгал азыҳәамҭа, аԥшаара алагаразы.	Введите запрос, чтобы начать поиск.
Аилазааратә гәыԥ ақьаадқәа аԥшьы анеирҭа азин аҭара	Разрешить приложению доступ к файлам сообщества
Ацҳамҭахь аҭак ҟарҵоит аилазааратә гәыԥ анапхгаҩцәа	На сообщения отвечают администраторы сообщества
Ишәыдаҳныҳәалоит! Анҵамҭа Шәара шәдаҟьаҟны иҟалоит.	Поздравляем! Запись появится на вашей странице.
Ажәаҭара аиқәырхара иамуит, ԥыҭрак ашьҭахь игәашәҭа.	Не удалось сохранить обещание, попробуйте позже.
Анҵамҭақәа иреиҳаӡоу ахыԥхьаӡара анҵоуп	Добавлено максимальное число записей
Шәцәаныррақәа аарԥшразы иманшәало амҩа:	Хороший способ выразить ваши эмоции:
Аԥҵаҩы инапынҵамҭа ырцәоуп	Подпись автора выключена
Арҿыцрақәа рҟнытә аҽаныхра	Отписаться от обновлений
Аҭахҳәага аҩызарахь аԥыхра	Отменить заявку в друзья
Ахьӡынҵа еиқәаҵәахь ацҵара	Добавить в чёрный список
Иарку агәыԥ аҟынтәи аҭыҵра	Выход из закрытой группы
Ҳшәыҳәоит, иашәырба арыцхә	Пожалуйста, введите дату
Дарбан сдаҟьа ззыԥшаауа иконтактқәа аниигалак ашьҭахь	Кто может найти мой профиль при импорте контактов
Ахәмарра азин аҭара Шәҩызцәа рахь анеира	Разрешить игре доступ к вашим друзьям
Шәара ишәылшом ари аилакратә аҿы иҟоу аҭӡамц ахәаԥшра.	Вы не можете просматривать стену этого сообщества.
Агәазыҳәарақәа сиахь ацҵара	Добавить в список желаний
Аинформациатә технологиақәа	Информационные технологии
Аиԥылараҟны алахәцәа ыҟаӡам	Во встрече нет участников
Аҭахҳәага ахарҭәаара аҭахуп	Заявка требует дополнения
Ахә зшьаз рыхьӡынца аарԥшра	Показать список оценивших
Иарбоуп иԥшаау аилкаанҵақәа	Показаны найденные статьи
Иҿыцу аԥшранҵақәа рҭагалара	Добавить новые фотографии
Шәдаҟьа ашәарҭара иҭагылоуп	Ваша страница в опасности
Зны-зынла Ацхыраара аиуразы еиҳа иманшәалоуп аҩыза идаҟьа ахархәара.	Иногда бывает удобнее обратиться в Поддержку со страницы друга.
Шәара шәҩызцәа рыхьӡынҵаҿы иҟоу ауааи шәареи аимадара алшара шәыбжьазар, шәдаҟьахь анеирҭа шьақәшәыргылар ҟалоит урҭ рыцхыраарала. Ишәҭахума иацышәҵарц?	Если у вас есть возможность связаться с людьми из вашего списка друзей, можно восстановить доступ к странице с их помощью. Хотите продолжить?
Абри адаҟьа иалкааны аԥшаара	Искать именно эту страницу
Ахатәы цҳамҭақәа рҿы аԥшаара	Искать в личных сообщениях
Ацҳамҭақәа рҭоурых арыцқьара	Очистить историю сообщений
Аҿыц аилазааратә гәыԥ аԥҵара	Создание нового сообщества
Еиуеиԥшым авариантқәа ралхра	Выбор нескольких вариантов
Ажәалагала уажәшьҭа игәаҭоуп.	Предложение уже обработано.
Аԥшранҵа адәахьтәи асаит аҟны	Фотография на внешнем сайте
Аҩызцәа рыхьӡынҵамҭа ариашара	Редактировать список друзей
ианышәҵа шәԥа ма шәыԥҳа рыхьӡ	введите имя сына или дочери
Раԥхьа азҿлымҳара змоу арбара	Показать сначала интересные
Шәара шәынҵамҭа аӡәгьы ибаӡом	Вашу запись никто не увидит
Анхараҿы арыцқьареи ацхыраареи	Уборка и помощь по хозяйству
Ари аилазааратә гәыԥ аанкылоуп	Это сообщество заблокировано
Ари альбом шәбоит Шәара заҵәык	Этот альбом виден только вам
Зегь шәыршанха: шәгәы ҳалалыз!	Удивите всех: будьте добрее!
Ишьақәырӷәӷәоу аҭахҳәага ԥыхра	Отмена подтвержденной заявки
Уиаԥхьатәи аҿаҵаҩҩрақәа арбара	Показать предыдущие подписки
Иазгәашәҭ азхьарԥш, арымарахьтәи амениу аҟны ижәбарц ишәҭаху:	Укажите ссылки, которые вы хотели бы видеть в меню слева:
Ахьӡмаӡа ишьҭуп аԥшьы ВКонтакте аҟны Шәыбжьылда ахь. Иҟалозар, шәхы иашәырхәа убри ахьӡмаӡа.	Код отправлен в приложение ВКонтакте на Ваш телефон. Пожалуйста, используйте этот код.
Абот изы архиагақәа еиқәырхоуп.	Настройки для бота сохранены.
Азин змада ари авидео ахәаԥшра?	Кто может смотреть это видео?
Аҭыӡҭыԥ иалшом 170 иреиҳаны асимволқәа амазаара	Адрес не может содержать больше 170 символов
Авидеонҵамҭа иарбоуп аспам еиԥш.	Видеозапись отмечена как спам.
Иҟалозар, иашәыркы ари аԥенџьыр.	Пожалуйста, закройте это окно.
Шәхы иашәырхә шәхатәы шәажәамаӡа	Используйте собственный пароль
Ахатәыхьӡ ма амаӡажәа иашаӡам. Даҽа знык игәашәҭ.	Логин или пароль неверный. Попробуйте ещё раз.
Шәдаҟьа аанкылоуп зхыԥхьаӡара рацәахаз ахҵарақәа «Исгәаԥхоит» азы.	Аккаунт заблокирован за большое количество отметок «Нравится».
Ажәабжьқәа рыхьӡынҵа ахьыӡ анышәҵа	Введите название списка новостей
Алаҳәара мап ацәкуп амодератор ила	Объявление отклонено модератором
Аԥшранҵақәа аилазааратә гәыԥ аҟынтә	Фотографии со страницы сообщества
Аҩызцәа рымш иирақәеи реиԥыларақәеи	Дни рождения друзей и мероприятия
Шәара иахьа ишәышьҭхьеит аҭахҳәага.	Вы уже отправляли заявку сегодня.
Ашәарҭадаратә кодуоуртәеиԥш аҟаҵара:	Способы получить код безопасности:
Шәхатә ҭӡамцахь анҵамҭа азнагатәума?	Поделиться записью на своей стене?
Шәдаҟьа ВКонтакте аанкылоуп. Алшара шәымоуп аацҳара ҳзаашәышьҭырц шәдаҟьа анаартхалак ашьҭахь.	Ваша страница ВКонтакте заблокирована. Вы сможете написать сообщение после разблокировки.
Ари анҵамҭа макьана аӡәгьы иазнеимгацт.	Этой записью пока никто не поделился.
Иазҿлымҳақәо аиԥыларақәа шәықалақь аҟны	Популярные мероприятия в вашем городе
Шәымш иира арыцхә қәҿиарала еиқәырхоуп.	Ваша дата рождения успешно сохранена.
Насгьы ишәгәалаҳаршәоит, шәара ишәылшоит амузыка азыӡырҩра:	А также напоминаем, что теперь вы можете слушать музыку:
Иҟалозар, абаг ажәакала изеиԥшроу шәҳәа.	Пожалуйста, опишите баг в двух словах.
0.49 грн. инарҭбааны	0.49 грн. подробнее
Адаҟьахь азхьарԥшра:	Ссылка на страницу:
Аилацәажәара далцоуп	Исключить из беседы
Аицлабра ахыркәшара:	Окончание конкурса:
Алкаақәа рахь аиасра	Перейти к закладкам
Апортативтә атехника	Портативная техника
Ари адҵаалара аныхра	Удалить этот запрос
Аудионҵамҭа азнагара	Поделиться эпизодом
Ахәыҷтәы порнографиа	Детская порнография
ацҳамҭа аҩҩра даҿуп…	набирает сообщение…
Ацҳарақәа мап ацәкра	Запретить сообщения
Ашықәс ҿыц ВКонтакте	Новый год ВКонтакте
Аҩызцәа рымш иирақәа	Дни рождения друзей
Аҩызцәеи аҽаҵаҩҩцәеи	Друзья и подписчики
ВКонтакте Афестиваль	Фестиваль ВКонтакте
ВКонтакте ахь аиасра	Перейти к ВКонтакте
Иҵегь аҩызцәа арбара	Показать ещё друзей
Казахтәылатәи атенге	Казахстанский тенге
Кристина Поплавскаиа	Кристина Поплавская
Свидеонҵамҭақәа рахь	К моим видеозаписям
Сыбжьынҵамҭақәа рахь	К моим аудиозаписям
Шәара шәзы еиҭашьақәыргылан шәхатә цҳамҭақәа, ахарбгалаҩ ила иныхаз шәдаҟьа аҟнытә.	Вам были восстановлены личные сообщения, удалённые с вашей страницы взломщиком.
Абжьынҵамҭа ныхтәума?	Удалить аудиозапись?
ажәеиларкка анҵамҭахь	комментарий к записи
Ажәеиларкка анҵамҭахь	Комментарий к записи
Акомпиутертә атехника	Компьютерная техника
Алҵшәақәа реиқәырхара	Сохранить результаты
Альбомқәа рахь ацҵара	Добавление в альбомы
Ампыҵакҩыс ахаргылара	Назначить владельцем
Анапылампылтә команда	Волейбольная команда
Анаԥхгаҩцәа рыхьӡынҵа	Список руководителей
Арҿиамҭақәа, аҭитәқәа	Произведения, товары
Асеансқәа зегь рыркра	Завершить все сеансы
Аҭиҩы иажәеиларккақәа	Комментарий продавца
Ахархәаҩцәа рҭауарқәа	Товары пользователей
Аҳәынҭқарра еилкааӡам	Страна не определена
Иҵегь ахҭысқәа арбара	Показать ещё события
свидеоқәа рахь ацҵара	добавить в мои видео
Свидеоқәа рахь ацҵара	Добавить в мои видео
Ҳшәыҳәоит, иалшәх ҵаҟа иаагоу аҭыԥқәа руак. Уи цхыраагӡахар алшоит адаҟьа аанкылара мзызс иамаз, иҳаҵанаҳәоит ари аҩыза аҭагылазаашьа ҳаԥхьаҟа ақәымшәара.	Пожалуйста, выберите один из пунктов ниже. Это может пролить свет на причины заморозки страницы и подскажет, как избежать таких ситуаций в будущем.
Авидеонҵамҭазы азашшра	Жалоба на видеозапись
Аӡәгьы ибжьы имҭииӡеит	Никто не проголосовал
Аиҿкааҩцәа ражәабжьқәа	Новости организаторов
Амодератор ихаргылара:	Назначить модератора:
Анҵамҭа ҿыц аҭӡамц аҿы	Новая запись на стене
Аԥшранҵақәеи аҿыханҵеи	Фотография и живопись
Аҭакқәа рахь аҽаҵаҩҩра	Подписаться на ответы
Аҭыӡҭыԥи аусура аамҭеи	Адреса и время работы
Афотоҭыхымҭақәа ацҵара	Добавление фотографий
Иактуалтәу аԥшранҵақәа	Актуальные фотографии
Иреиӷьоу аҟнытә аныхра	Удалить из избранного
Ишьақәшәыргыл аԥшранҵа	Установите фотографию
Анҵарба иалшом 15 иреиҳаны асимволқәа амазаара	Индекс не может содержать больше 15 символов
Закәытә рҿыцрақәеи ажәабжьқәа рҿы ирбо сҩызцәа	Какие обновления видят в новостях мои друзья
Аилазааратә гәыԥ ԥшаам.	Сообщество не найдено.
Аԥшранҵақәа рҭагалара »	Загрузить фотографии »
Асахьаҭыхымҭа адҳәалара	Прикрепить изображение
Аҽаҵаҩҩцәа рҿы ааныжьра	Оставить в подписчиках
Ашшыбӷьыц иадкылаӡамызт	Жалоба не была принята
Иҵегь ацҳамҭақәа арбара	Показать ещё сообщения
Ишиашо ицо аефир зызки?	О чем ваша трансляция?
Ари анҵамҭа рбарҭоуп иааигәоу шәҩызцәа рымацара	Эта запись видна только вашим близким друзьям
Дарбан сшьаҿақәа збо «Ашьаҿақәа ВКонтакте» аҟны	Кто может видеть мои шаги в «Шагах ВКонтакте»
Алахәцәа азҵааранҵаҿы уаҳа абжьы ҭиира рылшаӡом.	Участники больше не могут голосовать в опросе.
Абжьы аԥыхра ақәиҭымтәра	Запретить отмену голоса
Агәалашәарақәа рыхәаԥшра	Посмотреть воспоминания
Аиҭагара аҭоурых аҵәахра	Скрыть историю перевода
Алҵшәақәа зегьы раарԥшра	Показать все результаты
Апрограмматә еиқәыршәара	Программное обеспечение
Аԥошьҭа аиҭагара аҭоурых	История изменения почты
Аҭитә қәҿиарала иацҵоуп.	Товар успешно добавлен.
Аусмҩаԥгатәқәа реиҿкаара	Организация мероприятий
Ацҳарақәа аилакрақәа рҿы	Сообщения в сообществах
Ианышәҵа азхьарԥш ахҳәаа	Введите описание ссылки
Иарбоуп ииашам ажәамаӡа.	Указан неверный пароль.
Иҵегь аԥшранҵақәа арбара	Показать ещё фотографии
урыстәылатәи ахархәаҩцәа	российские пользователи
Шәажәеиларкка ахә ршьеит	Оценили ваш комментарий
Шәара ишәгәамԥхаз арбан?	Что Вам не понравилось?
Шәара ииашаҵәҟьаны ишәҭахума иаԥырышәхыр амобилтә бжьылда аномер аԥсахра?	Вы действительно хотите отменить изменение номера мобильного телефона?
Акатегориа иалшом 30 асимволқәа иреиҳаны амазаара	Категория не может содержать больше 30 символов
Ишәыдаҳныҳәалоит! Шәызгәаҭа қәҿиарала икьыԥхьоуп.	Поздравляем! ваша заметка успешно опубликована.
Аилацәажәара ахьӡ аԥсахра	Изменить название беседы
Аԥшранҵақәа рҿы ахҳәаақәа	Комментарии к фотографии
Ари анҵамҭа ианысымххьеи.	Я уже удалил эту запись.
Иҭашәгала аԥшаара аԥҟара.	Введите критерии поиска.
Ишиашо ицо аефир ала асра	Начать трансляцию звонка
Азгәаҭа иманшәаланы иныхуп	Заметка успешно сохранена
Аимадаратә дыррақәа арбара	Указать контактные данные
аҵыхəтəантəи х-аилыркаарак	три последних комментария
«Ԥсра зқәым аполк» акаҭаҿы	«Бессмертный полк» онлайн
Аԥсахрақәа анеиқәырхалагь ашьҭахь ари анҵамҭа ныххоит.	Эта запись будет удалена после сохранения изменений.
Аицлабраҟны шәхы алашәырхәа	Примите участие в конкурсе
Амаҵзура аамҭала иаанкылоуп	Сервис временно недоступен
Асахьақәа зегьы алаԥшхыгара	Посмотреть все изображения
Ашкол ацҵара азы аҿахәҳәага	Заявка на добавление школы
Азҿлымҳара змоу ала аилырхра	Сортировать по популярности
Аԥшранҵаԥсахга жәытә аарԥшра	Открыть старый фоторедактор
Аҭауар иқәыргылоуп вҭиирахь.	Товар выставлен на продажу.
Аҭел ахь анеирҭа ақәиҭымтәра	Запретить доступ к телефону
Ахархәаҩ иҭауарқәа архынҳәра	Вернуть товары пользователя
Ашшԥхьыӡ аӡыргаратә ҭоурыхаз	Жалоба на рекламную историю
Инарҭбаау адырраҭара аҵәахра	Скрыть подробную информацию
Аӡыргаразы аԥара ҳаргьежьуеит	Возвращаем деньги на рекламу
Акомпаниа агәыԥ 776 адиреқтор	Директор группы компаний 776
Аԥшранҵақәа альбом ахь ацҵара	Добавить фотографии в альбом
Дарбан сҭоурыхқәа збарц зылшо	Кто может видеть мои истории
Даҽа аилазааратә гәыԥк арбара	Показать ещё одно сообщество
Агәыԥаҿы аилыргара ала аԥшаара	Поиск по обсуждениям в группе
Адәқьан архиагақәа еиқәырхоуп.	Настройки магазина сохранены.
Ишәыдышәкыл иаразнак ҩ-ҳамҭак.	Принимайте сразу два подарка.
Аилацәажәара ааншәыжьыр шәара ишәоулоит, иҿыцу аацҳарақәа иалахәу рҟнытә. Шәара ишәылшоит ахынҳәра иҭацәу аҭыԥқәа анаало.	Покинув беседу, вы не будете получать новые сообщения от участников. Вы сможете вернуться при наличии свободных мест.
Абжьынҵамҭа иқәҿианы иҭагалоуп.	Аудиозапись успешно загружена.
Анеира аиҭашьақәыргылара залшом	Доступ восстановить невозможно
Аҵыхәтәантәи алҵшәақәа агәаҭара	Показать предыдущие результаты
Иарбоуп аҵыхәтәантәи ардыррақәа	Показаны последние уведомления
Иԥхьам аиҿцәаҽжәарақәа раарԥшра	Показать непрочитанные диалоги
Шәара ишәылшоит шәхаҭа шәацҵара	Вы можете добавить только себя
Аԥшьы ацҳамҭақәа рдәықәҵара азин аҭара аилазааратә гәыԥ ахьӡала	Разрешить приложению отправлять сообщения от имени сообщества
Еиҵыху ахыԥхьаӡараҭҵаарҭа аҿакра	Включить расширенную статистику
Шәҭел ахь секундқәак ирҭагӡаны инашьҭхоит 6-хыԥхьаӡарак змоу акод.	На ваш телефон в течение нескольких секунд придёт 6-значный код.
Санқт-Петербург, апр. Невскии, 28	Санкт-Петербург, Невский пр., 28
Иахәҭоуп ишәгәалашәозар ашәарҭадаратә ԥҟара хадақәа Аинтернет аҟны:	Необходимо помнить об основных правилах безопасности в Интернете:
Аелектронтә ԥошьҭа ииашам аҭыӡҭыԥ.	Неверный адрес электронной почты.
Алаҳәара аныхуп иреиӷьуқәа рҟнытә.	Объявление удалено из избранного.
Аԥшранҵа аилазааратә гәыԥ адаҟьаҿы	Фотография на странице сообщества
ВКонтакте амобилтә хархәагақәа рзы	ВКонтакте для мобильных устройств
Шәыграффити аилазааратә гәыԥ аҭӡамцахь	Создание граффити на стене сообщества
Шәҩызцәа аҳамҭақәа рзышәышьҭыр алшоит.	Вы можете отправить подарки мужчинам.
Аԥшранҵа аҭыԥахь адҳәалара ахсаала аҟны	Прикрепить фотографию к месту на карте
Аԥшранҵа қәҿиарала иацҵоуп ахсаала ахь!	Фотография успешно добавлена на карту!
Араҟа иарбахоит Шәара шәвидеонҵамҭақәа.	Здесь будут показаны ваши видеозаписи.
Шәахьынхо ақалақь қәҿиарала еиқәырхоуп.	Ваш город проживания успешно сохранён.
Ахьӡынҵа еиқәаҵәа иҭагалоу ауаа ирылшаӡом шәдаҟьа агәаҭара, ажәеиларккақәа ааныжьра насгьы ацҳамҭақәа шәара шәахь аҩҩра.	Люди из чёрного списка не могут просматривать вашу страницу, оставлять комментарии и отправлять вам личные сообщения.
Аилазааратә гәыԥ анаԥхгара аԥшьы азин амоуп	Приложению доступно управление сообществом
Ииашацәҟьаны абри ацыԥха анышәхыр шәҭахума?	Вы действительно хотите удалить этот ключ?
Ишәыдаҳныҳәалоит! Ацҳамҭа қәҿиарала ишьҭуп.	Поздравляем! Сообщение успешно отправлено.
Ари аԥшьы аилазааратә гәыԥахь ацҵара зыҟалом	Это приложение нельзя добавить в сообщество
Ари авидео ихҩоу альбомахь заҵәык ацҵара алшара амоуп	Данное видео можно добавить только в закрытый альбом
Ишьақәшәырӷәӷәа ишшәоуыз анеирҭа ахатә дыррақәа рахь.	Подтвердите получение доступа к персональным данным.
Шәдаҟьа аанкылоуп идәықәҵоу абри еиԥш аҳәара аиҩызарахь:	Аккаунт заблокирован за отправку таких заявок в друзья:
Иарку аусмҩаԥгатә аҟны анапхгаҩы заҵәык ааԥхьара ҟаиҵар илшоит.	На закрытое мероприятие может пригласить только администратор.
Ҳаҭамыз, аха Шәара ишәылшаӡом ари ахархәаҩ аҩызцәа рахь иацҵара.	К сожалению, вы не можете добавить этого пользователя в друзья.
Ҳсервисқәа аибадырреи аиҿцәажәареи алшара шәнаҭоит. ВКонтакте шәхы ишашәырхәо, шәара ишәшоит адырраҭарақәа насгьы шәҳацхраауеит асервис аиӷьтәра. Еизаҳго адыррақәа закәу, насгьы ҳхы ишаҳархәо шәдырырц азын, шәхы азышьҭны иҭышәҵаа амаӡалатә политика.	Наши сервисы позволяют вам знакомиться и общаться. Используя ВКонтакте, вы также делитесь информацией и помогаете улучшать сервисы. Чтобы узнать, какие сведения мы собираем и как их используем, внимательно изучите нашу политику конфиденциальности.
Азгәаҭа иҿахҵәоуп, избанзар иахәҭоу ашәага аасҭа еиҳахеит.	Заметка обрезана, так как её максимальный размер превышен.
Уажәшьҭа ари анҵамҭа иҟалоит Шәҩызцәа ржәабжьқәа рҿы.	Теперь эта запись появится в новостях у ваших друзей.
Аиҿцәажәарахь анеира ԥкуп иоафициалым архиагала	Доступ к чату ограничен настройками приватности
Шәааӡырҩы: ари ацҳамҭа аҭак азыҟаҵара аҭахым.	Внимание: отвечать на это сообщение не нужно.
Ииашаҵәҟьаны ишәҭахума ари азгәаҭа анышәхыр?	Вы действительно хотите удалить эту заметку?
адыррақәа ахархәаҩцәа зегьы ирбалар алшоит.	информация станет видна всем пользователям.
Аелектронтә ԥошьҭа аҭыӡҭыԥ аформат иашам.	Неверный формат адреса электронной почты.
Апроцесс ахыркәшахоит секундқәак рышьҭахь	Процесс завершится через несколько секунд
Дарбан сеихьӡарақәа збо ахәмаррақәа рҿы	Кто может видеть мою активность в играх
Сара саргәамҵуеит сдыррақәа ашәарҭадара	Меня беспокоит безопасность моих данных
Ауаажәларратәи асоциалтәи еиҿкаарақәа	Социальные и общественные организации
Ахатә цҳамҭақәа сара сахь аҩҩра зылшо	Кто может писать мне личные сообщения
Аӡыргаратә даҟьа, аԥшаара зырҟьашьуа	Рекламная страница, засоряющая поиск
Ихадоу альбом аҿ асахьақәа ыҟаӡам.	В основном альбоме нет фотографий.
Мап, сара ҽа номерк схы иасырхәоит	Нет, я воспользуюсь другим номером
Аҭӡы аҟны макьана нҵамҭакгьы ыҟам	На стене пока нет ни одной записи
Ииашам алогин ма ажәамаӡа арбоуп.	Указан неверный логин или пароль.
Инагӡаны ишәам ашәатәқәа шәымоуп.	У вас есть незавершенные платежи.
Аклассикатә интерфеис ахь аиасра	Перейти в классический интерфейс
Азҵааранҵа азы асахьа аҭагалара	Загрузка изображения для опроса
Аԥхьатәи ажәеиларккақәа рарбара	Показать предыдущие комментарии
Аргыларатәи арҽеиратәи усурақәа	Строительные и ремонтные работы
Абаг ахь аӡәгьы иҽаҵаҩҩмҩаӡацт	На баг ещё никто не подписался
Сҳамҭақәа рыхьӡынҵа збар зылшо	Кто видит список моих подарков
Абанктә картала ахыԥҳьаӡалара	Зачисление с банковской карты
Аилакқәа рзы аԥара аиагарақәа	Денежные переводы сообществам
Ажәабжь ҿыцқәа рылҵшәахыԥшаа	Результаты поиска в новостях
Аԥшьы ацаԥхақәа зегьы рныхра	Удалить все ключи приложения
ВКонтакте ашәарҭадаратә ҟәша	Центр безопасности ВКонтакте
Шәҩызцәа рыхьӡынҵахь анеирҭа	Доступ к списку ваших друзей
Азгәаҭа «Исгәаԥхоит» аныхра	Удаление отметки «Нравится»
Аиԥылараҟны шәҩызцәа ыҟаӡам	Во встрече нет ваших друзей
Аҟәша «Аҿыцқәа» рахь ацҵара	добавление в раздел «Новые»
Аладатә Африкатә Республика	Южно-Африканская Республика
Аԥхьатәи ажәабжьқәа рарбара	Показать предыдущие новости
Ахархәага қәҿиарала иныхуп.	Устройство успешно удалено.
ВКонтакте иаԥшааз алҵшәақәа	Результаты поиска ВКонтакте
Егьырҭ амобилтә хархәагақәа	Другие мобильные устройства
Сшәыҳәоит, иалышәх ақалақь.	Пожалуйста, выберите город.
Ҳшәыҳәоит, далшәхырц аԥҵаҩы	Пожалуйста, выберите автора
Аилакра анҵамҭақәа аҵәахра	Скрывать записи сообщества
Ахархәаҩ иҭауарқәа аҵәахра	Скрыть товары пользователя
Ахьӡанҵа еиқәаҵәахь ацҵара	Добавление в чёрный список
Аҩызцәа рааԥхьара аҟаҵашьа	Способы приглашения друзей
Иҟалозар, ақалақь ашәырба.	Пожалуйста, укажите город.
Сыԥшранҵақәа рҟынтәи алхра	Выбрать из моих фотографий
Адыррақәа еиҭа рдәықәҵара	Отправить данные повторно
Аинтерфеис ҿыц ахь аиасра	Перейти в новый интерфейс
Алҵшәақәа зегьы рыхәаԥшра	Посмотреть все результаты
Англыз бызшәала арбара.	Показать на английском.
Аԥара аигаразы азҵаатәхәы	Запрос денежного перевода
Арҿыцрақәа рахь аҽаҵаҩҩра	Подписаться на обновления
Иҟам измыԥхьац анҵамҭақәа	Нет непрочитанных записей
Авидеонҵамҭақәа ԥшааӡам.	Видеозаписей не найдено.
Ари иарку аусмҩаԥгатәоуп	Это закрытое мероприятие
Егьырҭ адаҟьақәа рарбара	Показать другие страницы
егьырҭ аиҿкаарақәа рыҟны	на остальных устройствах
Сахьыҟоу аҭыԥ азынашьҭра	Отправить местоположение
Шәвидеонҵамҭа ахә ршьеит	Оценили вашу видеозапись
Аҟазареи арлахҿыхрақәеи	Искусство и развлечения
Ардыррақәа зегьы рныхра	Удалить все уведомления
Агәыԥ аҟны агәыҳалалра	Пожертвование в группе
Адаҟьа ашьақәырӷәӷәара	Подтверждение страницы
Аилацәажәара ахьӡ ҿыц:	Новое название беседы:
Альбомқәа ражәеилкаара	Комментарии к альбомам
Ардырра ҿыцқәа ыҟаӡам.	Нет новых уведомлений.
Асаит аҟны агәыҳалалра	Пожертвование на сайте
Ацҳамҭақәа рхыԥхьаӡара	Количество приглашений
Ианышәҵа ахәԥса мааҭла	Введите сумму в рублях
Иашәырба аҵараиурҭа.	Введите университет.
Иҭагалақәо аԥшранҵақәа	Загруженные фотографии
Уиаԥхьатәи абжьынҵамҭа	Предыдущая аудиозапись
Ааигатәи аусмҩаԥгатәы	Ближайшее мероприятие
Абжьылда ажәытә номер	Старый номер телефона
Абжьынҵамҭақәа рныхра	Удаление аудиозаписей
Ажәеиларккақәа аҿыхуп	Комментарии отключены
Ажәеиларккақәа рҿыхра	Выключить комментарии
Аилазаарахь аиасрақәа	Переходы в сообщество
Аиҿцәажәаҩцәа рыцҵара	Добавить собеседников
Ақьаад ҿыц аҭагалара:	Загрузить новый файл:
Алкаақәа рахь ииагоуп	Сохранено в закладках
Амҵәышәымпылтәи агәыԥ	Баскетбольная команда
Аԥҵаҩы иахь аҽаҵаҩҩра	Подписаться на автора
Ахатә ажәаҭара аԥҵара	Создать своё обещание
Ахәаԥшра ахь ахынҳәра	Вернуться к просмотру
Аҵыхәтәантәи активра:	Последняя активность:
ВКонтакте ала аҭалара	Войти через ВКонтакте
Еицырдыруа аилакрақәа	Популярные сообщества
Изылшода сара асзасра	Кто может мне звонить
Аблогаҿы анҵамҭа ҿыц	Новая запись в блоге
Авидеонҵамҭа алышәха	Выберите видеозапись
Авидеонҵамҭа аԥсахра	Редактирование видео
Адырраҭара асаит аҿы	Уведомления на сайте
Азгәаҭа ианыхуеит.	Заметка удаляется.
аилакратә ацҳамҭақәа	сообщения сообщества
Алаҳәаразы ашшыԥхьыӡ	Жалоба на объявление
Анапаҵаҩра анаԥхгара	Управление подпиской
Анҵәамҭатә алҵшәақәа	Финальные результаты
асахьаҭыхымҭа ацҵара	добавить изображение
Асахьаҭыхымҭа ацҵара	Добавить изображение
Аҭакқәеи ардыррақәеи	Ответы и уведомления
Аҭиирахь ақәыргылара	Выставить на продажу
Аҭоурыхқәа рнаԥхгара	Управление историями
Аультраконсервативтә	Ультраконсервативные
Аҵыхәтәантәи активра	Последняя активность
Босниеи Герцеговинеи	Босния и Герцеговина
Иҭажәгал аԥшранҵақәа	Загрузите фотографии
Шәынҵамҭа ахә ршьеит	Оценили вашу заметку
Авидеонҵамҭа ашьҭра	Отправка трансляции
Адаҟьа иамоуп агха:	Страница с ошибкой:
Ажәеиларкка аныхуп.	Комментарий удалён.
Аконтент анҵамҭақәа	Публикация контента
Алахәцәеи аӡыргареи	Участники и реклама
Алахәылаҩ иалхра.	Выбрать партнёра.
Аԥшранҵақәа зышьҭра	Отправка фотографии
Аԥшранҵақәа рырбара	Показать фотографии
аԥшранҵақәа рыцҵара	добавить фотографии
Аԥшранҵақәа рыцҵара	Добавить фотографии
Ари иарку агәыԥ ауп	Это закрытая группа
«Архиагақәа» аартра	Открыть «Настройки»
Атранслиациа адаҟьа	Страница трансляции
Аусмҩаԥгатәы аԥҵара	Создать мероприятие
Ахәмарра аанкылоуп.	Игра заблокирована.
Ацхыраара ВКонтакте	Поддержка ВКонтакте
аҩызцәа рахь ацҵара	Добавление в друзья
Веб-камерала аҭыхра	Снимок с веб-камеры
Иалху аплатформақәа	Выбранные платформы
Иаԥхьааиуа раарԥшра	Показать предыдущие
Кристина Третиакова	Кристина Третьякова
Ҟазахсҭан ВКонтакте	Казахстан ВКонтакте
Ҿыцны ишәыдышәкылаз	Недавно добавленные
Шәызҵаара ҭашәгала…	Введите ваш вопрос…
Шәномер џьаргьы ицәырҵӡом асаит аҭаларазы заҵәык ахархәара амоуп. Аусура зегьы хәыда-ԥсадоуп.	Ваш номер нигде не выводится и используется только для входа на сайт. Вся процедура бесплатна.
Ари ахҭыс ала аԥхьара адкылара ма мап ацәкра Шәара ишәылшоит адаҟьа аҟны :	Принять или отклонить приглашение на это мероприятие вы можете на странице:
Шәдаҟьа аанкылан зыгәрагам аԥшранҵақәа ахьааанашьҭуаз азы.	Аккаунт заблокирован за отправку подозрительных фотографий.
Ари азҵааранҵа ихадароу аилак адаҟьа аҿы уаҳа иарбаӡахом.	Этот опрос больше не выводится на главной странице группы.
Агха ҟалазар ҟалап, мамзаргьы ашәатәы мап ацәкын	Возможно, произошла ошибка или платёж был отменён
Иашәырба шәҩыза мамзаргьы аилазааратә гәыԥ рыхьӡ	Начните вводить имя друга или название сообщества
Ишәыдаҳныҳәалоит! Азхьарԥш шәдаҟьаҟны иҟалоит.	Поздравляем! Ссылка появится на вашей странице.
Ашәарҭадара агха аԥошьҭа ашьақәырӷәӷәараан.	Ошибка безопасности при подтверждении почты.
Ҳара ишәыдаагалаӡом ари азхьарԥшахь аиасра.	Мы не рекомендуем переходить по этой ссылке.
Шәдаҟьа аҭыӡҭыԥ қәҿиарала иԥсахуп абри ала:	Адрес вашей страницы был успешно изменён на:
Аԥара ахыхра шәақәшаҳаҭхара ашьақәырӷәӷәаразы ианышәҵа ишәоуз акод. Ақәшаҳахара аус аулоит 90 мшы. Шәара еснагь ишәымоуп алшара ақәшаҳаҭхара аԥыхра Ахә ашәашьа аҟәша аҟны.	Для подтверждения вашего согласия на списание средств введите полученный код. Согласие будет действовать 90 суток. Вы всегда можете отменить согласие в разделе Способы оплаты.
Ари адаҟьа аӡәгьы џьаргьы иазнеимгацт.	Этой страницей пока никто не поделился.
Ахархәаҩ ахьӡынҵа еиқәаҵәахь дацҵоуп.	Пользователь добавлен в чёрный список.
Аилак ампыҵакҩы қәҿиарала дыԥсахуп.	Владелец сообщества успешно изменён.
Ари аҭыԥ аҟны аӡәгьы иҽаимырбаӡацт.	В этом месте ещё никто не отмечался.
Атема ахьӡи архиагақәеи еиқәырхоуп.	Название и настройки темы сохранены.
Аусмҩаԥгатәы алахәцәа зегьы рырбара	Показать всех участников мероприятия
Ахсаала сыԥшранҵақәа зну збар зылшо	Кто видит карту с моими фотографиями
Уи шәдаҟьа аанкылара шәацәнахьчоит.	Это поможет вам избежать блокировки.
Аилазааратә гәыԥ аҿы аԥшьы арбара	Показывать приложение в сообществе
Аԥшаара ақалақь ма амҩа ахыӡь ала	Поиск по названию города или улицы
Аҵыхәтәантәи х-жәеиларккак арбара	Показать последние три комментария
Иаарту аусмҩаԥгатә аҟны агәаҳәара змоу зегьы рҽаладырхәыр алшоит.	В открытом мероприятии могут участвовать все желающие пользователи.
Иашәырба ахьӡ мамзаргьы анагӡаҩ	Введите название или исполнителя
Аԥшьы ВКонтакте ашьақәыргылара	Установить приложение ВКонтакте
Афакультет ацҵаразы аҿахәҳәага	Заявка на добавление факультета
ВКонтакте шәажәамаӡа аҵәахӡом.	ВКонтакте не хранит ваш пароль.
Иҭабуп! Шәыхәшьара еиқәырхоуп.	Спасибо! Ваша оценка сохранена.
Абраузертә аацҳарақәа рҿаҵара	Включить оповещения в браузере
Аԥшьы агенерациатә кодқәа рзы	Приложение для генерации кодов
Ианышәҵаз анҵамҭақәа раарԥшра	Показать опубликованные записи
Ажәабжьқәа рыхьӡынҵа аԥсахра	Редактировать списки новостей
Ажәеиларкка мыцхәы икьаҿоуп.	Комментарий слишком короткий.
Ашьҭыбжьтә ардыррақәа аҿакуп	Звуковые уведомления включены
Иҟалозар, иашәырба ауадаҩра.	Пожалуйста, укажите проблему.
Инарҭбаау адырраҭара аарԥшра	Показать подробную информацию
Сфакультет ахьӡанҵаҿы иҟаӡам	Моего факультета нет в списке
Ииашаҵәҟьаны ишәҭахума ари ахархәаҩ иҭауарқәа рыҵәахра?	Вы действительно хотите скрыть товары этого пользователя?
Абри аҩыза ақәыԥшыла ыҟоуп.	Такой шаблон уже существует.
Ажәеиларкка наунагӡа аныхра	Удалить комментарий навсегда
Еиҳа авидеонҵамҭақәа арбара	Показать больше видеозаписей
Шәыҭитә акаталог ахь ацҵара	Добавьте ваш товар в каталог
Агәра ганы шәыҟоума аҭыхра аиқәырхарада иҿаԥышәҵар шышәҭаху, нас аԥенџьыр аркра?	Вы уверены, что хотите прервать рисование без сохранения результата и закрыть окно?
Изҩымҭоу изинҭарада абжьынҵамҭа ахархәара иақәиҭтәым.	Аудиофайл не должен нарушать авторские и смежные права.
Аҩызарахь аҭахҳәага ԥшаам.	Заявка в друзья не найдена.
ВКонтакте аԥара аиагарақәа	Денежные переводы ВКонтакте
Иҟалозар, иалышәха амҩаду.	Пожалуйста, выберите улицу.
Шәара ишәылшоит 10 фаил еиҳамкәа аацҳарахь адҵара.	Вы можете прикрепить к сообщению не более 10 файлов.
Аӡыргаратә ақциа агәаҭара	Посмотреть рекламную акцию
Аҭыҵразы иашәырба ажәамӡа	Изменение пароля для входа
Ацҳамҭахь аиасра атемаҟны	Перейти к сообщению в теме
ВКонтакте амобилтә версиа	Мобильная версия ВКонтакте
Еиԥшу аӡырҩрҭақәа аԥҵоуп.	Похожие аудитории созданы.
Шәынҵамҭа ахь ажәеиларкка	Комментарий к вашей записи
Адгаларақәа зегьы арбара	Показать все рекомендации
Анаҩстәи ашьаҿахь аиасра	Перейти к следующему шагу
Аԥара аиагарақәа раартра	Открыть денежные переводы
Ахьӡынҵа еиқәаҵәа арҭәра	Пополнение чёрного списка
Аҽаҵаҩҩцәа зегьы рырбара	Показать всех подписчиков
Иашәырба аԥшранҵа ашәага	Укажите размер фотографии
Сальбомқәа рахь ахынҳәра	Вернуться к моим альбомам
Аԥшьқәа зегьы раарԥшра.	показать все приложения.
Ааԥхьара мап ацәышәкеит	Вы отклонили приглашение
Альбом иаартны ааныжьра	Оставить альбом открытым
Ахархәаҩцәа рхыԥхьаӡара	Количество пользователей
Иҵегь ардыррақәа арбара	Показать ещё уведомления
Сыԥшранҵақәа аҭӡамц аҿы	Фотографии на моей стене
Абри ахархәаҩ иахь аԥара шәышьҭырц шәылшоит.	Вы можете отправить деньги этому пользователю.
Абжьылда номер аԥсахра	Изменить номер телефона
Адаҟьа аидентификатор:	Идентификатор страницы:
Азхьарԥш ахьыӡ анышәҵа	Введите название ссылки
Аинструменталтә музыка	Инструментальная музыка
Анцәахаҵаратә аиҿкаара	Религиозная организация
Жәабран 14 адныҳәалара	Поздравить с 14 Февраля
Жәабран 23 адныҳәалара	Поздравить с 23 Февраля
Иҵегь алҵшәақәа арбара	Показать ещё результаты
Ииашаҵәҟьаны ишәҭахума ари алԥшаага аныхра?	Вы действительно хотите удалить эту подборку?
Шәдаҟьа аанаҳкылеит ахԥатәи аган рзин еилажәгазар ахьалшо аҟынтә	Ваша страница заблокирована за возможное нарушение прав третьих лиц
Ари адаҟьазы аҿахәҳәага адәықәҵара ҟалаӡом	Подача заявки для данной страницы невозможна
Авидеонҵамҭа азнагара	Поделиться трансляцией
Аӡыргаратә нҵамҭа ҿыц	Новая рекламная запись
Аицлабра хыркәшахьеит	Конкурс уже завершился
Аныҳәарақәа реиҿкаара	Организация праздников
Аԥшьы анаԥхгара аҭара	Управление приложением
Атематикақәа рыԥсахра	Редактирование тематик
Ахархәаҩцәа рдаҟьақәа	Страницы пользователей
Еиқәырхоу аԥшранҵақәа	Сохранённые фотографии
Зегь реиҳа иззыӡырҩуа	Популярные аудиозаписи
Ирхиатәуп адгаларақәа	Настроить рекомендации
Сара 18 шықәса схыҵит	Мне исполнилось 18 лет
Сҩызцәеи урҭ рҩызцәеи	Друзья и друзья друзей
Иахьа Адунеитә аҳәса рымш аныҳәоуп. Шәара ишәылшоит аҳәса аҳамҭақәа рзышәышьҭыр.	Сегодня отмечается Международный женский день. Вы можете отправить подарки женщинам.
Агха АТОЛ: Ахатәыхьӡ ма амаӡажәа иашаӡам	Ошибка АТОЛ: Неправильные логин или пароль
Ари авариант азы аӡәгьы ибжьы имҭииӡацт.	За этот вариант ещё никто не проголосовал.
Аҵыхәтәантәи 24 сааҭ адаҟьа шәаҭаауазма?	Вы посещали страницу за последние 24 часа?
ВКонтакте иалагоит агеолакациатә ӡыргара	ВКонтакте запускает геолокационную рекламу
Ииашаҵәҟьаны ишәҭахума аҽаҵаҩҩра аԥыхра?	Вы действительно хотите отменить подписку?
Ажәеиларкка азышьҭуп	Комментарий отправлен
Аимадаратә дырраҭара	Контактная информация
аиҭабжьыҭира ҟалаӡом	переголосовать нельзя
Аиҭабжьыҭира ҟалаӡом	Переголосовать нельзя
Алеқсандр Сорочински	Александр Сорочинский
Анаҩстәи аудионҵамҭа	Следующая аудиозапись
Аоперациатә диреқтор	Операционный директор
Апромокод арцыхцыхра	Активировать промокод
Аԥшранҵа аиқәырхара.	Фотография сохранена.
Арыжәтә азыҟазаашьа:	Отношение к алкоголю:
Атеқст аҩҩра шәалага	Начните вводить текст
ахархәаҩцәа ҽнак азы	пользователей в сутки
Ашәарҭадара агәаҭара	Проверка безопасности
Иазҿлымҳақәо аԥшьқәа	Популярные приложения
Константин Брилевски	Константин Брилевский
Французтәи Полинезиа	Французская Полинезия
Хәыда-ԥсада агәаҭара	Попробовать бесплатно
Абри ардырра макьана аӡәгьы игәамԥхеит.	Это сообщение пока никому не понравилось.
Абри адаҟьа макьана аӡәгьы игәамԥхеит.	Это страница пока никому не понравилась.
Азхьарԥш ари адомен змоу ыҟоуп асиаҿы.	Ссылка с этим доменом уже есть в списке.
Абжьы аҭаны аарԥшра	Раскрывать со звуком
Авидеонҵамҭа ацҵара	Добавить видеозапись
Авидеофаил ԥшааӡам.	Видеофайл не найден.
Аӡыргаратә алаҳәара	Рекламное объявление
Аӡыргаратә наплакы:	Рекламное агентство:
Аиларкыгатә маҭәахә	справочные материалы
Аилахәра ахь аиасра	Перейти в сообщество
Алаҳәара аиқәырхара	Сохранить объявление
Аԥшьқәа рырхиагақәа	Настройки приложений
Ари ацҳамҭа аҵәахра	Скрыть это сообщение
Арыжәтә азыҟазаашьа	Отношение к алкоголю
Аҭак ҿыц аҭӡамц аҿы	Новый ответ на стене
Аусмҩаԥгатәы ацҵара	Добавить мероприятие
Афаил ҿыц аҭагалара	Загрузить новый файл
Ахархәага адҳәалара	Привязать устройство
Ахьӡынҵа ҿыц аԥҵара	Создать новый список
Ашәарҭадаратә агха.	Ошибка безопасности.
Егьи ақалақь арбара	Указать другой город
егьырҭ ахархәагақәа	остальные устройства
Инарҭбааны аилкаара	Подробная информация
Иреиӷьу алаҳәарақәа	Избранные объявления
Иреиӷьу рахь ацҵара	Добавить в избранное
Ахархәаҩ ари аҩыза аелектронтә ԥочшьҭала иҽҭаигалахьеит.	Пользователь с этой электронной почтой уже зарегистрирован.
Адаҟьа аанкылоуп анаҩс аҭалара аҟынӡа	Страница заблокирована до первого входа
Абжьынҵамҭа аныхра	Удалить аудиозапись
авидеонҵамҭа ныхра	удалить видеозапись
Агәыԥ ахь ааԥхьара	Пригласить в группу
Агха иазку ацҳамҭа	Сообщение об ошибке
Ажәеиларкка аныхра	Удалить комментарий
Аицлабра алҵшәақәа	Результаты конкурса
Алацәажәара ацҵара	Добавить обсуждение
Алашьақәырӷәӷәашьа	Способы авторизации
Алԥшаага адҳәалара	Прикрепить подборку
Алҵшәақәа раарԥшра	Показать результаты
Амҩаԥгаҩцәа мацара	Только координаторы
Аполитикатә партиа	Политическая партия
Аԥошьҭа ҿыц аԥҵара	Создать новую почту
Аԥшранҵақәа ацҵара	Добавить фотографию
Аԥшранҵақәа рныхра	Удаление фотографии
Аркәашагатә музика	Танцевальная музыка
Ахархәаҩцәа заҵәык	Только пользователи
Ахархәаҩцәа ралхра	Выбор пользователей
Ацҳамҭа адәықәҵара	Отправить сообщение
Ашәарҭадаратә агха	Ошибка безопасности
Ашкол ахь ааԥхьара	Приглашение в школу
Егьырҭ ахархәаҩцәа	Другие пользователи
- Иалышәх альбом -	- Выберите альбом -
Иреиӷьу ацҳамҭақәа	Избранные сообщения
Шәҳамҭа азышьҭоуп.	Ваш приз отправлен.
Шәдаҟьа аанаҳкылеит ишаны ирылашәҵаз ацҳамҭа еиԥшқәеи гәырӷьаҿҳәашатә цҳамҭақәеи рзы.	Мы заблокировали Вашу страницу за рассылку так называемых писем-цепочек или писем счастья.
Ацҳамҭа зышьҭхаӡом, избанзар аҵыхәтәантәи аамҭазы аилазааратә гәыԥ аҭӡамцаҿы мыцхәы ирацәаны иааныжьын ажәеиларккақәа.	Сообщение не может быть отправлено, так как на стене сообщества было оставлено слишком много комментариев за последнее время.
Шәдаҟьа аанкылан вики-адаҟьа ариашара ахьазуз азы:	Аккаунт заблокирован за редактирование вики-страницы:
Ацҳамҭақәа рвиджет алшамҭа ҿыцқәа	Новые возможности виджета сообщений
Ари аҭел аномер шәхы архәара шәылшаӡом, иаанкылоу адаҟьа иахьадҳәалоуп иахҟьаны.	Вы не можете использовать этот номер, так как он привязан к заблокированной странице.
Ацҳамҭа ааиуеит минуҭк аҵыхәала.	Сообщение придёт в течение минуты.
Ҳәыҳәоит, иашәырба даҽа ҭыӡҭыԥк.	Пожалуйста, выберите другой адрес.
Азҵааранҵа шәдаҟьа аҟны икыдуп.	Опрос размещен на вашей странице.
Ианыху адаҟьа аиҭашьақәыргылара	Восстановление удалённой страницы
Шәара ари аилацәажәара шәалцан.	Вы были исключены из этой беседы.
Асаит аԥҟарақәа реилагара инарымаданы атранслиациа аанкылан.	Трансляция была заблокирована в связи с нарушением правил сайта.
Еицырдыруа ахаҿы ма аколлектив	Известная личность или коллектив
Аилакра иаҿнахеит ацҳамҭақәа.	Сообщество отключило сообщения.
Ихәыдаԥсадоу аинтернет-дәқьан шәеилазаараҿы	Бесплатный интернет-магазин в Вашем сообществе
Шәдаҟьа аанкылоуп, избанзар 10 нызқь ааԥхьарақәа рзышьҭын агәыԥқәа рахь, урҭ макьаана ахархәаҩцәа ирыдрымкылаӡацт.	Эта страница была заблокирована, так как было разослано более 10 тысяч приглашений в группу, ещё не принятых получателями.
Шәдаҟьа аанкылан игәрагам ахьӡи ажәлеи рыԥсахра иахҟьаны:	Аккаунт заблокирован за подозрительную смену имени и фамилии:
Агәра шәга, аилазаара анаԥхгаҩҵәа зегьы аԥҟарақәа шырдыруа. Урҭ реилагарақәа рзын аилазаара иалшоит наӡаӡа ицәыӡыр алшара аҭоурых акьыԥхьра.	Убедитесь в том, что все руководители сообщества знают о правилах. За их нарушение сообщество может навсегда лишиться возможности публиковать истории.
Ахҳәаа ззыҟаҵоу аҳасабырба астатус аԥсахра	Изменение статуса прокомментированного отчёта
Ҳшәыҳәоит, иалшәх акатегориа	Пожалуйста, выберите категорию
Ажәабжьқәа акыԥхьра аамҭала	Новости по времени публикации
Азгәаҭа «Исгәаԥхоит» ацҵара	Добавление отметки «Нравится»
Ари адныҳәаларатә цҳамҭоуп.	Это подозрительное сообщение.
Аҭаларазы арҵабыргра аҿыхра	Отключить подтверждение входа
Иашәырба ииашоу аҭел аномер	Введите верный номер телефона
Шәара шәалахәуп аицлабраҿы.	Вы уже участвуете в конкурсе.
Шәҩызцәеи шәазхьаԥшыҩцәеи ари абжьынҵамҭа рзынашьҭра	Поделиться аудиозаписью с вашими друзьями и подписчиками
Ари аԥенџьыр хҩоит секундқәак рашьҭахь.	Это окно закроется через несколько секунд.
Шәдаҟьа аанкылан аҳамҭа ахь анапынҵазы:	Аккаунт заблокирован за подпись к подарку:
ВКонтакте аҭоурыхтә цәаҳәа	Историческая лента ВКонтакте
Еиҳа ажәеиларккақәа арбара	Показать больше комментариев
Иашәырба атеқст аԥшранҵазы	Укажите текст для фотографии
Сдаҟьа ажәеиларкка арҭаӡом	Мою страницу не комментируют
Шәдаҟьа аанкылоуп егьырҭ ахархәаҩцәа ВКонтакте рахь лассы ихьымӡӷу ахымҩаԥгара ахьаашәырԥшуаз иахҟьаны.	Ваша страница заблокирована за систематическое оскорбительное поведение в адрес других пользователей ВКонтакте.
Шәдаҟьа аанкылан зыгәрагам ақәыӷәӷәарақәа аӡыргаратә лаҳәарақәа.	Аккаунт заблокирован за подозрительные клики на рекламные объявления.
Шәдаҟьа аанкылан игәрагам аиҩызарахь аҳәара иахҟьаны. Иаҳҳәап, аҳәара ари ахархәаҩ иахь:	Аккаунт заблокирован за подозрительные заявки в друзья. Например, за заявку этому пользователю:
Абжьқәа хәыда-ԥсада аиура	Получение голосов бесплатно
Апродуктқәа рыхкы арҿыцра	Обновление версий продуктов
Ари аҭыԥ ахсаалаҿы арбара	Показать это место на карте
Атранслиациа ахьӡ анышәҵа	Введите название трансляции
Аҭоурыхтә активра аарԥшра	Показать историю активности
Онлаин аилакрақәа рҿакра.	Включить онлайн сообщества.
Сеилакқәа рсиа збар зылшо	Кто видит список моих групп
Шәара альбомкгьы шәымаӡам	У вас нет ни одного альбома
Аилакра онлаин арцәара шәхашәмыршҭлан	Не забывайте выключать онлайн сообщества
Ахархәаҩ аусмҩаԥгақәа рахь ааԥхьара азин аимҭеит.	Пользователь запретил приглашать себя на мероприятия.
Шәара ииашаҵәҟьаны ишәҭахума ақәҿыҭрақәа нышәхыр? Ари аус аԥыхра ҟалаӡом.	Вы действительно хотите удалить оповещение? Отменить действие будет невозможно.
Ари ашьаҿа ашьҭахьҟа ишәзырхынҳәуам.	Отменить это действие будет невозможно.
Ацхыраара ахьӡала азҵаара ҿыц аԥҵара	Создать новый вопрос от имени поддержки
Шәхаҵкы, ианышәҵа аблокировка амзыз.	Пожалуйста, укажите причину блокировки.
Аԥошьҭатә ҭыӡҭыԥ аԥсахра	Изменение почтового адреса
Аԥшьқәа аус рыуразын иарбанзаалак ихарҭәаагоу афаилқәа аҭахӡам. Иазгәашәымҭан аԥшьқәа рыдцалара иҭажәгал афаил, шәкомпиутер авирус иашәырхьырц шәҭахымзар.	Для работы приложений не требуется никаких дополнительных файлов. Игнорируйте требования приложений скачать исполняемый файл, чтобы не заразить свой компьютер вирусом.
Аилазаара аҭоурых иауӡом аҭыԥаркра:	В историях сообществ нельзя размещать:
Изылшода аԥшранҵақәа рҿы сазгәаҭара	Кто может отмечать меня на фотографиях
Абжьылда аномер аԥсахра	Изменение номера телефона
Аилак аԥшранҵақәа зегьы	Все фотографии сообщества
Аилактә бжьынҵақәа рахь	К аудиозаписям сообщества
Аиԥыларазы агәаларшәара	Напоминание о мероприятии
Аиҭагара аҭоурых арбара	Показать историю перевода
Амини-ԥшьықәа ВКонтакте	Мини-приложения ВКонтакте
Амобилтә бжьылда аномер	Номер мобильного телефона
Афатә аалыҵқәа, арыжәтә	Продукты питания, напитки
Ацҳамҭақәа реиԥш арбара	Показать в виде сообщений
Иаҭахым арбара адаҟьаҿы	Не показывать на странице
Инарҭбааны аҭитә ахҳәаа	Подробное описание товара
Шәыцҳамҭа ВКонтакте аҿы	Ваше сообщество ВКонтакте
Аилакра ахьӡынҵа еиқәацәа иацҵоуп.	Сообщество добавлено в чёрный список.
Ари анҵамҭа шәҩызцәа заҵәык ирбоит	Эта запись видна только вашим друзьям
Шәдаҟьа аанкылоуп зыгәрагам аудио ахьаанашьҭуаз азыҳәан.	Аккаунт заблокирован за отправку подозрительных аудиозаписей.
Ари аилацәажәара ишеибгоу зегь анышәхырц шәҭахыҵәҟоума?	Вы действительно хотите удалить всю переписку в этой беседе?
Аилазааратә гәыԥ анаԥхгара аԥшьы азин аиуеит	Приложению будет доступно управление сообществом
Шәдаҟьа аанкылоуп арҩашьыга ахьышәҭиуаз азы.	Ваша страница заблокирована за продажу алкоголя.
Иҟаҵаз аҳәарала аҭауарқәа ԥшааӡам	По данному запросу товары не найдены
Шәажәеиларкка анышәҵа.	Введите ваш комментарий.
Адокумент асахьа ҭышәх	Сфотографируйте документ
Азхьаԥш амаҵура амаӡам	Ссылка не поддерживается
Аилак аҭитә ахә ршьеит	Оценили товар сообщества
Аиҿцәжәара еиԥш арбара	Показать в виде диалогов
Алахәцәа рхыԥхьаӡарала	По количеству участников
Афаил алхрахь ахынҳәра	Вернуться к выбору файла
Ашықәс ҿыц адныҳәалара	Поздравить с Новым годом
Иаԥхьоу еиԥш азгәаҭара	Отметить как прочитанные
Ишәгәаԥхаз аԥшранҵақәа	Понравившиеся фотографии
Ишәыдыргало аилакрақәа	Рекомендуемые сообщества
Ари адаҟьа априваттә рхиагақәа рыла иаркуп.	Данная страница скрыта настройками приватности.
Шәдаҟьа аанкылоуп апорнографиатә материалқәа аҭыԥыркра иахҟьаны.	Ваша страница заблокирована за размещение порнографических материалов.
Ажәамаӡа аҟны абжьажь ыҟамзароуп	Пароль не должен содержать пробелов
Дарбан аинтернет аҿы избо сдаҟьа	Кому в интернете видна моя страница
Изылшода сынҵамҭақәа рыхцәажәара	Кто может комментировать мои записи
Шәара ишәылшоит шәхаҭа шәгәаҭара	Вы можете просматривать только себя
Ацыԥхақәа реиҭагара 6-мш инареиҳаны иагоит	в среднем перевод ключей занимает более 6 дней
Азинмазаараҩ икабинеҭ	Кабинет правообладателя
Ақәратәи аҳәаакрақәа:	Возрастные ограничения:
Альбом ҿыц ахь ацҵара	Добавить в новый альбом
Амаҵурҭатә маҭәахәқәа	Кухонные принадлежности
Ари адаҟьантәи аныхра	Удалить с этой страницы
Архәҭа аномер ҭажәгал	Введите войсковую часть
Ахеллоуин адныҳәалара	Поздравить с Хеллоуином
Аҩызцәа рыхьзынҵақәак	Некоторые списки друзей
Еиҳа аҭҳәаақәа арбара	Показать больше каналов
Иашәырба аномер ахьыӡ	Введите название номера
Исзаанхеит азҵаарақәа	У меня остались вопросы
Рҽаҵарҩҩит адаҟьа ахь	Подписались на страницу
Шәыԥшранҵа ахә ршьеит	Оценили вашу фотографию
Шәдаҟьа аанкылан аконкурсқәеи акциақәеи рымҩаԥгаразы, аԥҟарақәа иахьрықәымшәоз азы.	Ваша страница заблокирована за проведение конкурсов или акций, не соответствующих правилам.
Иарбоу абжьылда анумер ахархәара ҟалаӡом.	Нельзя использовать указанный номер телефона.
Ахархәаҩ аҩызцәарҿы даанхоит, аха аҭоурыхқәа иарбахаӡом ажәабжьқәа рҿы.	Пользователь останется в друзьях, но истории не будут показываться в новостях.
Шәдаҟьа аанкылоуп мчылатәи аныррақәа рахь аапхьара иахҟьаны.	Ваша страница заблокирована за призывы к насильственным действиям.
Шәхатә дыррақәа аԥшьы анеирҭа амазаауеит	Приложению будут доступны ваши личные данные
Аилактә бжьынҵақәа рахь ацҵара	Добавить в аудиозаписи сообщества
Аҭел аномер ала аԥшаара аҿыхын	Поиск по номеру телефона выключен
Авидеонҵамҭа ԥшааӡам	Видеозапись не найдена
Адинхаҵаратә усбарҭа	Религиозное учреждение
Аиқәырхара анагӡареи	Сохранить и продолжить
Аицлабра ималагаӡацт	Конкурс ещё не начался
Ақәратәи аҳәаакрақәа	Возрастные ограничения
Анеирҭа цаԥха аԥҵара	Создание ключа доступа
Аԥшранҵаԥсахга аркра	Закрытие фоторедактора
Ашшра ахархәаҩ изкны	Жалоба на пользователя
Иацлараны иҟоу аԥшьы	Добавляемое приложение
Ацҳамҭа зышьҭхаӡом, избанзар аҵыхәтәантәи аамҭазы Шәара шәыҭӡамцаҿы мыцхәы ирацәаны иааныжьын ажәеиларккақәа.	Сообщение не может быть отправлено, так как на вашей стене было оставлено слишком много комментариев за последнее время.
Шәдаҟьа аартразы, ҳшәыҳәоит, ишьақәшәырӷәӷәа адаҟьа шәара ишышәтәу, нас ажәамаӡа шәыԥсах.	Чтобы разморозить страницу, мы просим Вас подтвердить, что Вы владелец страницы, и сменить пароль.
Аилазаараҿын иаҽыхуп аацҳара асаит аԥҟарақәа ахьеилаго азы.	Сообществу отключены сообщения в связи с нарушением Правил сайта.
Шәдаҟьа аанкылоуп ԥхашьара змам ақәранамӡақәа рсахьа ахьықәыргылахоз иахҟьаны.	Ваша страница заблокирована за размещение непристойных изображений несовершеннолетних.
Ирмаҷу акопиа аредакциа азура	Редактирование уменьшенной копии
Араҟа иааншәыжь Шәара шәыдқьан ахҳәаа.	Разместите здесь описание вашего магазина.
Иалхоу аԥшранҵақәа рҿы ари аҭыԥ арбара	Указать это место на выбранных фотографиях
Ааԥхьара мап ацәкра	Отклонить приглашение
Ажәеиларкка зышьҭра	Отправить комментарий
Ажәеиларкқәа арԥсра	Отключить комментарии
Аиасрақәа аԥшьы ахь	Переходы в приложение
Аиқәшәара аанкылоуп	Встреча заблокирована
Аилацәажәара ацҵара	Продолжить обсуждение
Алҵшәақәа рыхәаԥшра	Посмотреть результаты
Амузыкатә ҽаҵаҩҩра.	Музыкальная подписка.
- Атематика алхра -	- Выберите тематику -
Аҭӡамцаҿы акьыԥхьра	опубликовать на стене
Ахатәы азырхиарақәа	Настройки приватности
Иалышәх адныҳәалара	Выберите поздравление
Иацҵаз рҟнытә агара	Убрать из добавленных
Иашәырба шәымш иира	Укажите дату рождения
Иҭабуп шәыбжьы азы!	Спасибо за ваш голос!
Иҭабуп Шәыбжьы азы.	Спасибо за ваш голос.
Шәара ишәылшом иҭажәгларц иҿыцу афаилқәа, избанзар иҭажәгалаз аконтент аԥшәма иҟынтәи иазааит ашшԥхьыӡ.	Вы не сможете загружать новые файлы, поскольку на опубликованный вами контент поступила жалоба от правообладателя.
Абраузертә аацҳарақәа рҿыхра	Отключить оповещения в браузере
Азхьарԥш ахархәаҩ идаҟьа ахь	Ссылка на страницу пользователя
Азхьарԥш ашәырба шәдаҟьа ахь	Укажите ссылку на вашу страницу
Анҵамҭа шәҩызцәеи шәҽаҵаҩҩцәеи рҟынӡа азнагара	Поделиться записью с вашими друзьями и подписчиками
Игәнаҳгоит, аспамерцәа шәдаҟьа рхы иахьадурхәаз ауааҭрацәа алаларазы агәыԥқәа аӡыргареи агәыԥқәа реиӷьтәрази.	К сожалению, спамеры использовали Вашу страницу для массового вступления в группы в целях рекламы и раскрутки этих групп.
Ақьаад шәҩызцәеи шәҽаҵаҩҩцәеи рҟынӡа азнагара	Поделиться файлом с вашими друзьями и подписчиками
Ақәратәи аҳәаакрақәа арбара	Указать возрастные ограничения
Ахылаԥшҩы ибӷьыц харҭәааӡам	Карточка куратора не заполнена
Иашәырба шәыбжьылда аномер.	Введите номер вашего телефона.
Ԥыҭҩык аиҿцәажәаҩцәа ралхра	Выбрать несколько собеседников
Ауадаҩра азыцҳара.	Сообщить о проблеме.
Ааԥхьара адкылоуп.	Приглашение принято.
Абжьынҵамҭа ацҵара	Добавить аудиозапись
Авеб-камера аҿыхра	Отключить веб-камеру
Авидеонҵамҭа ахьыӡ	Название видеозаписи
Авидеонҵамҭа ныхра	Удаление видеозаписи
Ажәеиларкка ацҵара	Добавить комментарий
Аиҿцәажәаҩ иацҵара	Добавить собеседника
Ақалақьтә еиҿкаара	Городское сообщество
Аҟәша ахьӡ аԥсахра	Переименовать раздел
Алахәылаҩцәа ԥшаам	Участники не найдены
Алахтыреи аҟазареи	Культура и искусство
Алаҳәарақәа рҿыхра	Отключить оповещения
Амобилтә ахархәага	Мобильное устройство
Амузыкатә аизгақәа	Музыкальные подборки
Аԥхын шԥашәхыжәга?	Как вы провели лето?
Аԥшранҵа аҭагалара	Загрузить фотографию
Аԥшранҵазы азашшра	Жалоба на фотографию
Арацәа хыԥхьаӡара:	Множественное число:
Ахьӡ зынӡа икьаҿуп	Слишком короткое имя
Ацхыраарахь анҵара	Написать в Поддержку
Ашшбӷьыц аԥшьы азы	Жалоба на приложение
Даҽа номерк арбара	Указать другой номер
Иалышәх аҵараиурҭа	Выберите университет
Иарку аусмҩаԥгатәы	Закрытое мероприятие
Иԥшаау аԥшранҵақәа	Найденные фотографии
Ихырҳагоу амаҭәахә	Контакты и материалы
Ишԥахьчатәу агәыԥ?	Как защитить группу?
Хәыда-ԥсада ацҵара	Продолжить бесплатно
Ацыԥхақәа реиҭагара 4-мш инареиҳамкәа иагоит	в среднем перевод ключей занимает не более 4 дней
Ацыԥхақәа реиҭагара 6-мш инареиҳамкәа иагоит	в среднем перевод ключей занимает не более 6 дней
Анапаҵаҩҩра ахәԥса: 149 мааҭ мызкы.	Стоимость подписки: 149 рублей в месяц.
Зтел аномер ала ацҳамҭақәа сзаазышьҭырц азин змоу ахархәаҩцәа	Какие пользователи могут отправлять мне сообщения по номеру телефона
Шәдаҟьа аанкылан игәрагам аинформациа шәара шәкантактқәа рҿы:	Аккаунт заблокирован за подозрительную информацию в ваших контактах:
Шәдаҟьа аанкылоуп зыгәрагам ахҵара «Исгәаԥхоит» азы.	Аккаунт заблокирован за подозрительную отметку «Нравится».
Зыбжьы зҭииз зегьы рырбара	Показать всех проголосовавших
Ари аилак аҟынтә ацҳамҭақәа соуларц сҭахӡам	Я не хочу получать сообщения от этого сообщества
Ажәабжьқәа рҭагалараан ԥынгылак ҟалеит. Ԥытрак ашьҭахь шәеиҭадҵаала.	Произошла ошибка при загрузке новостей. Попробуйте повторить запрос позднее.
аконтент, еилазго Аԥҟара ВКонтакте асаит ахархәара.	контент, нарушающий Правила пользования сайтом ВКонтакте.
Ааԥхьара адкылоуп	Приглашение принято
Ааԥхьара азышьҭра	Выслать приглашение
Абжьтәы цҳамҭақәа	Голосовые сообщения
абжьынҵамҭа ныхра	удалить аудиозапись
Абжьынҵамҭа ныхуп	Аудиозапись удалена
Аилахәыра ԥшааӡам	Компания не найдена
Аиҿцәажәаҩ иныхра	Удалить собеседника
Аҟәшақәа рырҿыцра	Обновления разделов
Амобилтә цхыраара	Мобильная Поддержка
Анҵамҭа аҭагалара	Опубликовать запись
Аԥшӡареи аҟазареи	Красота и искусство
Аԥшьқәа реизгақәа	Подборки приложений
Аҭоурых аиҭаҳәара	Поделиться историей
Аҭоурыхтә аобиект	Исторический объект
Ауадаҩра азыцҳара	Сообщить о проблеме
Ахархәаҩ ианҵамҭа	Запись пользователя
Еиҿартәыра ацҵара	Добавить устройство
Елджеи ильбом ҿыц	Новый альбом Элджея
Иазнажәга ажәабжь	Поделитесь новостью
Иацышәҵа аԥшранҵа	Добавьте фотографию
Иԥшаау ацҳамҭақәа	Найденные сообщения
Ихадоу адырраҭара	Основная информация
Сконтактқәа рхала	Только мои контакты
Шәлогин аҭаларазы	Ваш логин для входа
ВКонтакте иузудымкыло ахыҵхырҭақәа рацәоуп	ВКонтакте слишком много неприемлемых материалов
Ажәеиларкка шәҩызцәеи шәҽаҵаҩҩцәеи рҟынӡа азнагара	Поделиться комментарием с вашими друзьями и подписчиками
Авидео узахәаԥшӡом, аԥҵаҩы идаҟьа ахьаанкылаз азы	Видео недоступно, так как страница автора заблокирована
Агәҽанызаара! аҭалара арҵабыргра анаҿаку, амаҵура ажәамаӡа аиҭашьақәыргылара аҭел аномер ала узыҟаҵаӡом.	Внимание! Когда подтверждение входа включено, услуга восстановления пароля по номеру телефона становится недоступной.
Еиԥшу аӡырҩрҭақәа раԥҵара иамуит	Не удалось создать похожую аудиторию
Сара сдаҟьа абжьылда иадҳәалаӡам	Моя страница не привязана к телефону
Аӡыргаратә уадахь аиасра	Перейти в рекламный кабинет
Анҵамҭақәа рыцхәк аҟынӡа	Записи до определенной даты
Егьи ахархәага адҳәалара	Привязать другое устройство
Иалшәх амобилтә еимадара	Выберите сотового оператора
Ԥасатәи ахәшәаара арбара	Показать предыдущие платежи
Сара исымоуп даҽа даҟьак	У меня есть другая страница
Шәдаҟьа аанкылоуп, избанзар уахь инеит аԥҽра аҽаҵәыхьчара зын адгалара.	Ваша страница заблокирована, поскольку с неё поступали предложения услуг взлома.
Шәдаҟьа аанкылан агәҩара ахьыҟоу агәыҳалалратә еизгарақәа рзы.	Ваша страница заблокирована за подозрительные благотворительные сборы.
Агəҽанҵарақәа-ҿыц ыҟаӡам, аилагаҩцәа идырҽеиз.	Нет новых предупреждений, исправленных нарушителями.
Авидеоқәа рҿы ахҳәаақәа	Комментарии к видеозаписям
адаҟьа аныхуп наунагӡа.	страница удалена навсегда.
Альбом аԥҵареи аиагареи	Создать альбом и перенести
Амҩа ацҵаразы аҭахҳәага	Заявка на добавление улицы
Ахархәага ҿыц адҳәалара	Привязать новое устройство
Еиҳа аԥшранҵақәа арбара	Показать больше фотографий
Шәажәеиларкка ргәаԥхеит	Ваш комментарий понравился
Изылшода анҵамҭақәа рааныжьра сдаҟьаҿы	Кто может оставлять записи на моей странице
Аилак ацҳамҭақәа рахь анеирҭа аԥшьы ақәиҭтәра	Разрешить приложению доступ к сообщениям сообщества
Амобилтә ҭел ала ахыԥхьаӡалара	Зачисление через мобильный телефон
Иашәырба ахьыӡ.	Введите название.
Шәдаҟьа аанкылоуп ашәҟәыбӷьыцқәа аҭиира азы.	Ваша страница заблокирована за продажу документов.
Аԥшранҵа ҿыц аҭагалара	Загрузка новой фотографии
Ахьыӡла заҵәык аԥшаара	Искать только по названию
Еиҳа ацҳамҭақәа арбара	Показать больше сообщений
Иԥшаауп еиԥшу аӡырҩрҭа	Найдена похожая аудитория
Сыльбом ахь аиқәырхара	Сохранить к себе в альбом
Шәыҽшьақәшәырӷәӷәароуп	Необходимо авторизоваться
Анҵамҭақәа рыхцәажәара аҿыхра	Отключить комментирование записей
Ацҳамҭа аспам еиԥш иазгәаҭан.	Сообщение было помечено как спам.
Иазышьҭу ааԥхьарақәа раарԥшра	Показать отправленные приглашения
Иаразнактәи адырраҭара арбара	Показывать мгновенные уведомления
Ажәабжьқәа рыхьӡынҵа ахьыӡ иауцәоуп	Название списка новостей слишком длинное
Шәеимадага аҟынтә бжьынҵамҭак алшәх	Выберите аудиозапись на вашем компьютере
Агха. Аҿаҵатәы ԥшаам.	Ошибка. Заказ не найден.
Азиндырратә еибыҳәара	Юридическая консультация
Альбом ахҟьас аҟаҵара	Сделать обложкой альбома
Аҭыӡҩыра ацҵара ауӡом	Нельзя добавить граффити
Ауаажәларатә еиҿкаара	Общественная организация
Аҵара амш адныҳәалара	Поздравить с Днём знаний
аҩызцәа рыхьӡынҵақәак	некоторым спискам друзей
Иашәырба азгәаҭа ахьӡ	Введите название заметки
Иргәаԥхеит 41 123-ҩык	Понравилось 41 123 людям
Избарҭада атәым нҵамҭақәа сдаҟьаҿы	Кто видит чужие записи на моей странице
Хәымш рҟынтәи знык еиҳамкәа	Не чаще одного раза в пять дней
Адаҟьа иқәышаҳаҭгоуп	Страница верифицирована
Администратор далшәх	Выберите администратора
Ажәеиларкка азнагара	Поделиться комментарием
Аиура азы ақәшаҳаҭра	Разрешение на получение
Алгамҭа аамҭа арбара	Указать время окончания
Анформациа иацəмаҷуп	Недостаточно информации
Ари иаӡбоит сызҵаара	Это решает мою проблему
Аусмҩаԥгатәы ҟалеит:	Мероприятие состоялось:
Ахатә даҟьаҿы ианҵоу	Опубликованные на стене
Ахьӡ ишахәҭоу иарбам	Имя указано некорректно
Иҟалар зылшоз алахәылацәақыҟаӡам.	В сообществе нет возможных участников.
Ахархәаҩцәа зегьы рхыԥхьаӡара, шәынҵамҭа збаз.	Количество всех пользователей, увидевших вашу запись.
Ҳара еиқәҳаршәеит аҳамҭа ҷыда, шәҩызцәа ирзышәышьҭыр иҟало.	Мы подготовили специальный подарок, который можно отправить друзьям.
Аҭагалара аан апроблема шәызцәыҵуазар, иалшозар иҭашәгал апатреҭ ашәага маҷны.	Если у вас возникают проблемы с загрузкой, попробуйте выбрать фотографию меньшего размера.
Шәдаҟьа аанкылоуп ицәахыхгоу ацҳамҭақәеи амақаррази.	Аккаунт заблокирован за оскорбительные сообщения или угрозы.
Ианкьыԥхьыз аамҭала арбара	Показать по времени публикации
Иҟаӡам иаашьҭу ахархәаҩҵәа	Нет приглашённых пользователей
Шәдаҟьа аанкылоуп зыгәрагам аилакрахь ахалархәразы.	Аккаунт заблокирован за подозрительное вступление в группу.
Иахьа иазгәарҭоит Атәылахьчаҩцәа рымш.	Сегодня отмечается День защитника Отечества.
Адистанционтә рцара	Дистанционное обучение
Ажәалагала гәаҭоуп.	Предложение проверено.
Аицлабра аҽалархәра	Участвовать в конкурсе
Алырыҩра арҵабыргра	Сбросить подтверждение
Альбом анапы аҵжьра	Редактирование альбома
Альбомаҿы акьыԥхьра	Опубликовать в альбоме
Ари ардырра аҵәахра	Скрыть это уведомление
Ацҳамҭа адҳәалара..	Прикрепить сообщение..
Иалышәх ахархәаҩцәа	Выберите пользователей
Иаԥхьам ҳәа алкаара	Отметить непрочитанным
инарҭбааны аилкаара	Рассказываем подробнее
Ҳаҭыр зқәу ахархәаҩ	Уважаемый пользователь
Аҭитә азнагара шәҩызцәеи шәҽаҵаҩҩцәеи рҟынӡа	Поделиться товаром с вашими друзьями и подписчиками
Абаг ахҳәаа аҩҩра шәалага	Начните вводить описание бага
Абжьылда аномер ԥсаххоит!	Номер телефона будет изменён!
Абыжьтәы дырраҭара аҿакра	Включить звуковые уведомления
Аҭоурых аҭагалара иамуит.	Не удалось загрузить историю.
Егьырҭ аԥшранҵақәа арбара	Показать остальные фотографии
Амобилтә бжьылда аномер аԥсахра	Изменение номера мобильного телефона
Уажәшьҭа ари ахьарԥш адаҟьаҿы иубарҭахоит.	Теперь эта ссылка будет отображаться на странице.
Иашәырба аҭыԥ, аԥшранҵақәа ахьыҟаҵаз	Укажите место, где были сделаны фотографии
Иазназгақәаз рсиа арбара	Показать список поделившихся
Ҳшәыҳәоит, иашәырба ахьӡ	Пожалуйста, введите название
Ажәеиларкка нҵара.	Написать комментарий.
Ааԥхьара ақәиҭтәра	Разрешить приглашения
Адаҟьа аус адулара	Действия со страницей
Аилакра аанкылоуп.	Группа заблокирована.
Аинформациа ацҵара	Добавление информации
Ардыррақәа аҿакуп.	Уведомления включены.
Ацхыраарахь ашьҭра	Отправить в Поддержку
Иалху иҿцәажәаҩцәа	Выбранные собеседники
Шәдаҟьа аанкылоуп абри ахархәаҩ аҩызцәа рахь иацҵараз адгалар ашьҭразы:	Аккаунт заблокирован за отправку рекомендаций добавить в друзья этого пользователя:
Аԥшранҵа шәҩызцәеи шәҽаҵаҩҩцәеи рҟынӡа азнагара	Поделиться фотографией с вашими друзьями и подписчиками
Шәдаҟьаҟны аелектронтә ԥошьҭа адҳәалаӡам.	К вашей странице не привязана электронная почта.
Амениу аҟны апунктқәа рарбара	Настроить отображение пунктов меню
Ашырҳәа шәзыҽшьақәшәырӷәӷәом.	Мгновенная авторизация недоступна.
Еиԥшу аӡырҩрҭа аԥшаара иамуит	Не удалось найти похожую аудиторию
Мыцхәы иауу ацҳамҭа анышәҵеит	Вы ввели слишком длинное сообщение
Иалышәха аԥшранҵа, ахсаалахь иацышәҵар ишәҭаху	Выберите фотографию, которую хотите поместить на карту
Абаг қәҿиарала еиҭакуп.	Баг успешно отредактирован.
Аилакра иамазар алшоит:	Сообщество может содержать:
Аихара бзиаҿын ахәаԥшра	Смотреть в высоком качестве
Ахархәаратә аиқәшаҳаҭра	Пользовательское соглашение
Еиҳа ааԥхьарақәа арбара	Показать больше приглашений
Шәдаҟьа аанкылоуп абжьы аҭиира иахҟьаны.	Ваша страница заблокирована за продажу голосов.
Иалышәх авидеоҭаҩра шәкомпиутераҿы	Выберите видеозапись на вашем компьютере
Урысшәала арбара.	Показать на русском.
Абжьылдахь ашьҭра	Отправить на телефон
Адаҟьа иаанкылоуп	Аккаунт заблокирован
адаҟьахь ахынҳәра	вернуться к странице
Адаҟьахь ахынҳәра	Вернуться к странице
Ажәабжь акьыԥхьра	Опубликовать новость
Аилакра аанкылоуп	Группа заблокирована
Акод еиҭа аашьҭра	Выслать код повторно
Алахәҩыс аҟалашьа	Как стать участником
Альбом ҿыц аԥҵара	Создать новый альбом
Аԥшранҵа ҭагалара	Загрузите фотографию
Аԥшранҵахь аиасра	Перейти к фотографии
Ардыррақәа аҿакра	Включить уведомления
Ардыррақәа аҿакуп	Уведомления включены
Аспам азы азашшра	Пожаловаться на спам
Ахәмарра ихыртуп.	Игра разблокирована.
Ацҳамҭа дәықәҵоуп	Сообщение отправлено
ВКонтакте ацҵақәа	Приложения ВКонтакте
Иарбам акатегориа	Не указана категория
Шәҭауар ргәаԥхеит	Ваш товар понравился
Ари аҭел аномер шәхы архәара шәылшаӡом, иаанкылоу адаҟьа иахьадҳәалоуп иахҟьаны	Вы не можете использовать этот номер телефона, так как он привязан к заблокированной странице
Шәара ишәышьҭхьан ари абжьыҭиира шәдаҟьа ахь.	Вы уже отправляли это голосование к себе на страницу.
Шәара еиҳа ишәгәаԥхаз арбан?	Что Вам понравилось больше всего?
Иарбо аформат афаил иаднакылаӡом.	Данный формат файлов не поддерживается.
Адаҟьатәи сыԥшранҵақәа	Фотографии с моей страницы
Аҭак ҿыц ажәеиларккаҿы	Новый ответ в комментариях
Даҽа ҵараиурҭак ацҵара	Добавить учебное заведение
Сышкол ахьӡынҵаҿы иҟам	Я не могу найти свою школу
Адаҟьа аанкылан иахьышьҭыз зыгәра гам ацҳамҭақәа.	Аккаунт заблокирован за отправку подозрительных сообщений.
Адаҟьа аанкылан иахьышьҭыз зыгәра гам ацҳамҭақәа:	Аккаунт заблокирован за отправку подозрительных сообщений:
Аныҟәцаҩцәа рзы ахархагақәа	Инструменты для путешественников
Иахьа Атәылахьчаҩцәа рымшуп	Сегодня День защитника Отечества
Шәара ишәызҭагалаӡом ас еиԥш иҟоу аконтент, избанзар аԥшәма иҟынтә аилакы иазааит ашшԥхьыӡ.	Вы больше не сможете публиковать такой контент, поскольку на сообщество поступила жалоба от правообладателя.
инагӡаны арбара.	показать полностью.
Инагӡаны арбара.	Показать полностью.
Ишәыҩҩы ацҳамҭа.	Напишите сообщение.
Азинтә дырраҭара	Правовая информация
Аиагарақәа аиура	Получение переводов
Аилакқәа аԥышәҵа	Добавьте сообщества
Аиҭарбара аҿакра	Включить повторение
Анаҩс аиҭаҿаҵара	Воспроизвести далее
Анҵамҭа кьыԥхьуп	Запись опубликована
Аԥшранҵа алышәха	Выберите фотографию
Аԥшранҵа аԥсахра	Изменить фотографию
Аԥшранҵа арҿыцра	Обновить фотографию
Аԥшьы азыразхара	Одобрить приложение
Аҭагалара ацҵара	Продолжить загрузку
Ацҳамҭа ианыхуп.	Сообщество удалено.
Аҵыхәтәан иныхыз	Последние удалённые
Иҟашәҵа алаҳәара	Создайте объявление
Ихыҭҳәаау ашәара	Произвольный размер
Шәшьақәырӷәӷәоуп	Вы авторизованы как
Ари еиԥшу анҵамҭақәа ҵакыдоуп, баша асаит аҟьашьуеит, еиҳа ауаарацәа ацәханагалоит ари аҩыза ацҳамҭақәа рышьҭра. Ҳшәыҳәоит, шәҽалашәмырхәын ари аҩыза аус.	В подобных записях нет никакого смысла, они только засоряют сайт, провоцируя ещё большее количество людей на эти же опрометчивые действия. Пожалуйста, не участвуйте впредь в подобном.
Аԥшранҵақәа рыриашара	Редактирование фотографий
Еиԥшу аӡырҩрҭа аԥҵоуп	Создана похожая аудитория
Ажәақәа ацҳамҭаҿы еилыргам	Слова в сообщении не распознаны
Аԥшьы астатус аҟны аарԥшра	Показывать приложение в статусе
Иацҿаку асаитқәеи аԥшьқәеи	Подключённые сайты и приложения
Иԥхьакыз анҵамҭа кьыԥхьуп.	Отложенная запись опубликована.
Шәажәамаӡа аиакәым азҳәоуп	Ваш пароль был скомпрометирован
Аԥшранҵа аҭыӡҭыԥ қәҿиарала еиқәырхан	Местоположение фотографии успешно сохранено
ВКонтакте иаԥуп ахархәара ахыӡҵәҟьа инаӡаны, кириллицала иҩра. Иаҳҳәап: Кьасоу Ҳагба, Хьыбла Мықәба. Убри азы аҳәарақәак ахьӡ аԥсахрзы амодераторцәа изгәарҭо. Ҳшәыҳәоит, шәазԥшы ақәшаҳаҭра.	ВКонтакте принято использовать только настоящие имена в полной форме, написанные кириллицей. Например: Ян Иванов, Анна Петрова. Поэтому некоторые заявки на смену имени проверяются модераторами. Пожалуйста, дождитесь одобрения.
Аилакра шәацҳара аҭак ҟанамҵозар, онлаин шәырцәала.	Выключайте онлайн, когда сообщество не отвечает на сообщения.
Шәдаҟьа аанкылоуп зыгәрага аԥшьқәа рықәыргыларазы.	Аккаунт заблокирован за подозрительную установку приложения.
Шәзаҳәаз ашәҟәы Шәара ишәтәӡам	Запрошенная книга не принадлежит вам
Абыжьтәы дырраҭара аҿыхра	Отключить звуковые уведомления
Абжьынҵамҭа ахынҳәра	Восстановить аудиозапись
Акьыԥхьраз азыҟаҵара	Подготовить к публикации
Аныҳәа ҳзааигәахоит!	Праздник к нам приходит!
Иазышьҭу ааԥхьарақәа	Отправленные приглашения
Иалшәх аҵәахра амзыз	Выберите причину скрытия
Иашәырба альбом ахьӡ	Введите название альбома
Мыцхәы идуцәоуп ахьӡ	Слишком длинное название
Ахҳәаа ацышәҵа.	Добавьте описание.
Шәдаҟьа аанкылоуп ацҵара «аиқьтәра» ма амацзура азхьарԥшра иахҟьаны.	Ваша страница заблокирована за предложения «накрутки» или услуг по рассылке спама.
Мчыбжьыкахь знык еиҳамқәа алаҳәара	Оповещать не чаще одного раза в пять дней
Шәҩызцәа ирзымариахоит шәдырра, ииашацәҟьоу шәпатреҭ ҭашәгалар.	Друзьям будет проще узнать вас, если вы загрузите свою настоящую фотографию.
Аалыҵ «авидео» анапхгаҩы	руководитель продукта «Видео»
Еиҭагам ажәақәа раарԥшра	Показать непереведённые ключи
Иҭацәу адаҟьа ҿыц аԥҵара	Создать новую пустую страницу
Авидеонҵамҭа ԥшаам.	Видеозапись не найдена.
Ажәлар ракзаара амш	День народного единства
Амузикатә маругақәа	Музыкальные инструменты
Аофициалтә аилакра:	Официальное сообщество:
Афотосахьақәа ацҵам	Не приложены фотографии
Ахархәаҩ дыԥшааӡам.	Пользователь не найден.
Ишьақәырӷәӷәоу ауаа	Авторизованные партнёры
Шәынҵамҭа ргәаԥхеит	Ваша запись понравилась
Иаашьҭу ахарҳәаҩҵәа зегь раарԥшра	Показать всех приглашённых пользователей
Иалышәх амзыз.	Выберите причину.
Аилак адаҟьахь азышьҭра	Отправить на страницу группы
аилакратә аԥшьы авиџьет	виджет приложения сообщества
Ари анҵамҭа збарц зылшо	Кто сможет видеть эту запись
Асахьа авеқтортә формат	Векторный формат изображения
Асахьа арастратә формат	Растровый формат изображения
Ҳшәыҳәоит, иалшәх ахҟьа	Пожалуйста, выберите обложку
Шәԥочҭа шьақәырӷәӷәоуп.	Ваша почта уже подтверждена.
Аудионҵамҭа шәҩызцәеи шәҽаҵаҩҩцәеи рҟынӡа азнагара	Поделиться эпизодом подкаста с вашими друзьями и подписчиками
Зынӡа икьаҿуп аҭитә ахҳәаа.	Слишком короткое описание товара.
Иадаагалаз ажәабжь кьыԥхьуп	Опубликована предложенная новость
Аӡыргаратә хархәаҩ	Рекламный пользователь
Аҟазареи аԥшранҵеи	Искусство и фотография
Алаҳәара аанкылоуп	Объявление остановлено
Аофициалтә аилакра	Официальное сообщество
Аԥшранҵақәа ԥшаам.	Фотография не найдена.
Аргылареи аремонти	Строительство и ремонт
Арҽеиреи аргылареи	Ремонт и строительство
Атема ахьӡ аԥсахра	Изменить название темы
Ахҩылаанҵа аԥсахра	Редактировать описание
Аҳамҭақәа рыҵәахра	Скрывать блок подарков
Аҩышьаԥҟаратә агха	Орфографическая ошибка
Иаԥхьанеиуа асахьа	Предыдущее изображение
Имнеиӡеи ақәҿыҭра?	Не пришло уведомление?
Иԥшаау ахархәаҩцәа	Найденные пользователи
Аелектронтә ԥошьҭа ихарҭәаатәуп	Необходимо заполнить электронную почту
Изылшода анаԥхьара аԥшьқәа рахь	Кто может приглашать меня в приложения
Иҟалозар, иашәырба аизга ахьыӡ.	Пожалуйста, введите название подборки.
Зегьынџьара аҽышьақәырӷәӷәаразы иаку аԥҵамҭа	Единая платформа для авторизации во множестве сервисов
Аргылареи архитектуреи	Строительство и архитектура
Аҳәынҭқарратә аиҿкаара	Государственная организация
Даҽа ԥшранҵак ахсаалахь ацҵара	Добавить на карту ещё одну фотографию
Изылшода сааԥхьара аԥшьқәа рҿы	Кто может вызывать меня в приложениях
Имаҷу ахҳәаа ианаҭоит шәдаҟьа аиндивидуальность	Небольшое описание добавит вашей странице индивидуальности
Иаагоу амаҭәахә иаркуп иахьаҵанкуа	Данный материал заблокирован на территории
Адаҟьа ашҟа шәиас	Перейдите на страницу
Ажәабжь кьыԥхьуп.	Новость опубликована.
Азҵаара ҿыц аиура	Получить новый вопрос
Аилакқәа шәрыдгыл	Поддержите сообщества
Аинформациа шьҭуп	Информация отправлена
Аԥшранҵа ахәаԥшра	Посмотреть фотографию
Ардыррақәа аҿыхра	Отключить уведомления
Ахарҭәаара ацҵара	Продолжить заполнение
Ацҳамҭа ҿыц абжьы	Звук нового сообщения
Ашәа атекст ԥшаам	Текст песни не найден
Ашьақәырӷәӷәарахь	Перейти к авторизации
Ааигәа иацҵаз аҩызцәа	Недавно добавленные друзья
Адаҟьа иқәышаҳаҭгаӡам	Страница не верифицирована
Сзанааҭ ахьӡынҵаҿы иҟаӡам	Моей специальности нет в списке
Аҩбатәи аҩаӡара аиҵахы ацҵара	Добавить подзаголовок второго уровня
Шәара цҳамҭакгьы шәмышьҭӡеит.	Вы не отправили ни одного сообщения.
Аԥшранҵа аҭыӡҭыԥ қәҿиарала иныхын	Местоположение фотографии успешно удалено
Шәдаҟьа аанкылан игәрагам астатусазы:	Аккаунт заблокирован за подозрительный статус:
Аԥшьы аҳәоит шәеилектронтә ԥошьҭа аҭыӡҭыԥ	Приложение запрашивает доступ к вашему адресу почты
Шәдаҟьа аанкылоуп, избанзар шәара ҽаӡәы иԥшранҵақәа шәхы иашәырхәоит.	Ваша страница заблокирована, поскольку вы выдаёте фотографии другого человека за свои.
Адаҟьа ахархәара азуп иаарҳәу аилаӡараамаӡура ахҳәаақәа аилакра аҟынтәи.	Страница используется для обратной совместимости сервиса комментариев от имени сообщества.
Шәдаҟьа аанкылоуп, избанзар уаантә имҩаԥыган ашантажтә хархәара.	Ваша страница заблокирована, поскольку с неё осуществлялся шантаж пользователей.
Шәдаҟьа аанкылоуп, избанзар ҽаӡәы ихьӡала шәхы аашәырԥшуеит.	Ваша страница заблокирована, поскольку вы выдаёте себя за другого человека.
Иарбоу аҭел аномер шәдаҟьа иадышәҳәалахьеит.	Указанный номер телефона уже привязан к вашей странице.
Шәҩызцәеи шәҽаҵаҩҩцәеи рҟынӡа аԥшьы азнагара	Поделиться приложением с вашими друзьями и подписчиками
Сҩызцәа рыхьӡынҵа збар зылшо	Кто может видеть список моих друзей
Амзи амши мацара рарбара	Показывать только месяц и день
Аҷақ ахьӡ аԥсахра ҟалоит	Название кнопки можно изменить
Ахархәаҩцәа ԥшааӡам.	Пользователей не найдено.
Аҳаҭырларҟәратә ҵакы	Оскорбительное содержание
Ианышәҵа адаҟьа ахьӡ	Введите название страницы
Иашәырба аизга ахьыӡ	Введите название подборки
агәыԥахь анеирҭа	доступ к сообществам
Адгалара ҵәахуп.	Рекомендация скрыта.
Аиҭарбара аҿыхра	Отключить повторение
Амобилтә ԥшьақәа	Мобильные приложения
Апромокод аҿакуп	Промокод активирован
Аԥшранҵа аарҳәра	Повернуть фотографию
Аԥшранҵа армаҷра	Уменьшить фотографию
Аԥшранҵа ԥсахуп.	Фотография изменена.
Аԥшьы архиагақәа	Настройки приложения
Аԥшьы ахь аиасра	Перейти в приложение
Ардырра ацқьара:	Частота уведомлений:
Ардыррақәа аиура	Получать уведомления
Ари адаҟьа аркуп	Это закрытый профиль
Арҽеиратә усурҭа	Ремонтная мастерская
Аҭитә ҿыц ацҵара	Добавить новый товар
Аҭыхымҭа аԥсахра	Изменить изображение
ахархәаҩ иԥсахра	сменить пользователя
Ахыҵхырҭа ацҵара	Добавление источника
Ахьарԥш ариашара	Редактировать ссылку
Аҵаҳәара аҵәахра	Скрыть эту подсказку
ВКонтакте аԥҵаҩы	основатель ВКонтакте
Иаарту абжьыҭира	Открытое голосование
Шәдаҟьа аанаҳкылеит ареферальтә зхьарԥшқәа аларҵәаразы.	Мы заблокировали Вашу страницу за распространение реферальных ссылок.
Шәҩырақәа аилакра аҭӡамц ахь аҭаҩра уаҳа азин шәымаӡам.	На стену этого сообщества больше нельзя будет копировать ваши записи.
Шәдаҟьа аанкылан аҳәара аиҩызарахь азы:	Аккаунт заблокирован за отправку заявки в друзья:
Шхатә даҟьаҿ аҭоурых анҵатәума?	Опубликовать историю на вашей странице?
Азанааҭ ацҵаразы аҿахәҳәага	Заявка на добавление специальности
Адаҟьаҟны акьыԥхьра	Опубликовать на странице
Аҭел аномер арбаӡам	Не указан номер телефона
Даҽа архәҭак аҵцара	Добавить войсковую часть
Ихҩоу альбом ацҵара	Добавить закрытый альбом
Ааԥхьара аныхра	Удалить приглашение
Аԥшранҵа ахҳәаа	Описание фотографии
Ардырра ацқьара	Частота уведомлений
Арҵареи аҿиареи	Обучение и развитие
Асахьеи атексти	Изображение и текст
Аҭитә адҳәалара	Прикрепление товара
Ахәаԥшра ацҵара	Продолжить просмотр
Иалшәх аԥшьықәа	Выберите приложение
Иалышәх аԥшьқәа	Выберите приложения
ирҿыцуп абыржәы	обновлён только что
Ихадоу аԥшранҵа	Основная фотография
Уажәы акьыԥхьра	Опубликовать сейчас
Ҽазнык агәаҭара	Попробовать ещё раз
Аилак аԥшранҵақәа аԥшьы анеирҭа ақәиҭтәра	Разрешить приложению доступ к фотографиям сообщества
Аелектронтә ԥошьҭа ардырра	Электронная почта для уведомлений
Аԥышәа ариашара азин ааӡам	Нет прав на редактирование навыка
Амцҳәара мамзар ажьара	Обман или ввод в заблуждение
Иаагоу амаҭәахә иаркуп	Данный материал заблокирован
Шәдаҟьа аанкылоуп анаркотики арҩашьыга маҭәашьарқәа ахьышәҭиуаз азын.	Ваша страница заблокирована за продажу наркотических веществ или запрещённых препаратов.
Шәдаҟьа аанкылоуп абџьар аҭиира азы.	Ваша страница заблокирована за продажу оружия.
Аԥшранҵа хәыҷцәоуп	Фотография слишком мала
Ахҭысра аҽалархәра	Участвовать в челлендже
Даҽа аҭитәы арбара	Показать ещё один товар
Егьи амзыз арбара:	Указать другую причину:
Мчыбжьык аанкылара	Заблокировать на неделю
Шәызмыԥхьац ацҳара	Непрочитанные сообщения
Адаҟьа наӡаӡа иаанкылоуп.	Страница заблокирована навсегда.
Аԥшранҵа аҭагалара иамуит	Не удалось загрузить изображение
Шәдаҟьа аанкылан игәрагам арзаҳал аҭагаларазы:	Аккаунт заблокирован за загрузку подозрительного документа:
Араҟа Шәара ишәылшоит еиуеиԥшым азҵаара аҭара ВКонтакте азы.	Здесь вы можете задать любой вопрос об управлении своими данными и их защите.
Ахҭыс арҵабыргразы еиҭах иҭажәгалароуп ажәамаӡа шәдаҟьа аҟынтә.	Для подтверждения действия вам необходимо заново ввести пароль от вашей страницы.
Ацҳамҭа ҿыц ԥаҳәрада иацҵан.	Новая запись была успешно добавлена.
Шәазыҳәамҭа ала акгьы ԥшаам.	По вашему запросу ничего не найдено.
Ажәла ишахәҭоу иарбам	Фамилия указана некорректно
Ахатә цҳамҭала ашьҭра	Отправить личным сообщением
Шәдаҟьа аанкылан игәрагам аҭаҩра аҭагаларазы:	Аккаунт заблокирован за публикацию подозрительных записей:
Шәыцҳамҭа ҿыцқәа ахәаԥшра шәылшоит адаҟьаҟны:	Просмотреть ваши новые личные сообщения можно на странице:
Адаҟьа ҿыц аԥҵара	Создать новую страницу
Адырраҭара ыҟаӡам	Информация отсутствует
Анаплыхи аҟазареи	Рукоделие и творчество
Аԥшранҵа азнагара	Поделиться фотографией
Аспорттә еиҿкаара	Спортивная организация
Даҽа ҳамҭак алхра	Выбрать другой подарок
Шәара шәадҵаалеит ВКонтакте шәдаҟьа иазкны. Иара азыҟаҵара аамҭак агар алшоит. Афаил аныҟалалк, анҵаразы ишәзааҳашьҭоит ақьаад аӡхьарԥш аманы.	Вы запросили архив данных о вашем профиле ВКонтакте. Его подготовка может занять некоторое время. Когда файл будет сформирован, мы отправим вам письмо со ссылкой для скачивания архива.
Ари абаг шәара ишәзеиҭакӡом	Вы не можете редактировать этот баг
Уи аҳәара шәыдышәкылахьеит.	Вы уже приняли эту заявку в друзья.
Шәазыҳәамҭа ала акгьы ԥшаам	По вашему запросу ничего не найдено
Аилак аҭӡахьы аиасра	Перейти к стене сообщества
Аилырхра нас арҳәара	Перемешать и воспроизвести
Амш иира адныҳәалара	Поздравить с днём рождения
Аԥшьқәа рсиа аарԥшра	Показать список приложений
Ари адаҟьа аанкылоуп	Эта страница заблокирована
Ари сыуадаҩра аӡбуам	Это не решает мою проблему
Ацҳамҭа ахархәаҩ изы	Сообщение для пользователя
Ацҳара атекст арбара	Показывать текст сообщений
Иацҵоуп аԥшранҵа ҿыц	добавлена новая фотография
Иԥсхьоу ауаҩы идаҟьа	Страница умершего человека
Агха еиҭа ицәырҵуа иалагар, афотосахьа ахаҭа еиқәырханы дырҩегьых иҭажәгала.	Если ошибка продолжает возникать, попробуйте сохранить оригинал фотографии и загрузить её повторно.
Ацыԥха ҿыц ахәҭеи ахьӡи	Раздел и название нового ключа
Шәдаҟьа аамҭала иаанкылоуп апорнографиатә нҵамҭа аҭыжьразы. Анҵамҭақәа аныхымзар, аанкылара наӡаӡахоит.	Аккаунт временно заблокирован за публикацию порнографических материалов. Если материалы не будут удалены, блокировка будет пожизненной.
Шәалхра азгәаҭоуп абжьыҭиираҟны.	Ваш выбор учтён в результатах голосования.
Ақьаад аԥшранҵа:	Фотография документа:
Анапхгаҩы ацҵара	Добавить руководителя
анҵамҭа ариашара	редактирование записи
Арҵареи аҟазареи	Обучение и творчество
Асахьа аҭагалара	Загрузить изображение
ауаа зегь рҟынтә	от всех пользователей
Ауаа зегь рҟынтә	От всех пользователей
ахархәаҩ ихьӡала	от имени пользователя
Ахьыӡ кьаҿцәоуп.	Слишком короткое имя.
Ари аизга аҿы абжьынҵамҭақәа ыҟаӡам	В этом плейлисте пока нет ни одной аудиозаписи
Шәдырра ҿыцқәа шәдаҟьаҿы иарбахоит.	Новые данные будут отражены на вашей странице.
Абжьынҵамҭа аԥсахра	Редактировать аудиозапись
Ари ақьаад ианыхан.	Этот документ был удалён.
Иашәырба аҩыза ихьӡ	Начните вводить имя друга
Иқәышаҳаҭгоу адаҟьа	Верифицированная страница
Сдаҟьа ашҟа аиагара	Поместить на мою страницу
Аԥшранҵа ҭагалаӡамызт.	Фотография не была загружена.
Мышкы знык еиҳамқәа алаҳәара	Уведомлять не чаще одного раза в день
ООО «Меил.Ру» амаӡара аполитика	Политика конфиденциальности ООО «Мэйл.Ру»
Абри аматериал зышәкьыԥхьи?	Зачем вы опубликовали этот материал?
Абжьтәы цҳамҭа аԥыхра	Отменить голосовое сообщение
Аилацәажәара шәалцан.	Вы были исключены из беседы.
Аԥшранҵа шәдаҟьа аҟны	Фотография на вашей странице
Аԥшьқәа реизга аныхра	Удаление подборки приложений
Авидеонҵамҭа аркра	Прикрепление видеозаписи
Аԥшранҵа аанкылоуп	Фотография заблокирована
Аҭыӡҭыԥ аиқәырхара	Сохранить местоположение
Ацҳамҭа ацҵара.	Напишите что-нибудь.
Ааԥхьара аԥыхра	Отменить приглашение
Адаҟьа аиҭагара	Перевести в страницу
Аиҭагаҩ иацҵара	Добавить переводчика
Альбом ариашара	Редактировать альбом
Аԥшранҵа ардура	Увеличить фотографию
Атема ахьӡ ҿыц:	Новое название темы:
Ахьыӡ кьаҿцәоуп	Имя слишком короткое
ВКонтакте аԥшьы	Приложение ВКонтакте
Шәықәра ашәырба	Укажите свой возраст
ВКонтакте саамҭа рацәаны иақәыӡуеит	ВКонтакте отнимает у меня слишком много времени
300 000 бжьы ахыхәмарра	300 000 голосов 28 и 29 августа
Ишәзымдыруа ахархәаҩ	Незнакомый вам пользователь
Шәыԥшранҵа ргәаԥхеит	Ваша фотография понравилась
Избарҭада аԥшранҵақәа, сахьадырбаз	Кто видит фотографии, на которых меня отметили
Адақьа аанкылоуп.	Страница заблокирована.
Адаҟьаҿы аарԥшра:	Показывать на странице:
Еилкаам адәықәҵаҩ	Неизвестный отправитель
Сдаҟьа ахь аиасра	Перейти к моей странице
Секундқәак рыла аҭел ишәзасуеит иҷыдоу аномер. Ианышәҵа уи аномер аҵыхәтәантәи 4-хыԥхьаӡарак.	В течение нескольких секунд на ваш телефон поступит звонок-сброс с уникального номера. Введите последние 4 цифры этого номера.
Аԥошьҭа аҭыӡҭыԥ шьақәырӷәӷәоуп.	Указанный адрес почты успешно подтверждён.
Ааԥхьара шьҭуп	Приглашение выслано
Абжьтәы цҳамҭа	Голосовое сообщение
Азгәаҭа ԥшаам.	Заметка не найдена.
Аиҭагаҩ иныхра	Удалить переводчика
Альбом амаӡара	Приватность альбома
Аԥшьқәа реизга	Подборка приложений
Атема ариашара	Редактирование темы
Ацҳамҭа шьҭуп.	Сообщение отослано.
Иқәганы ацҵара	Убрать и продолжить
Иҭыҵуа ацҳамҭа	Исходящее сообщение
аалыҵ «Аԥшьқәа» анапхгаҩы	руководитель продукта «Сообщества»
Избарҭада смузыкақәа рсиа	Кто видит список моих аудиозаписей
Абжьыҭиира аамҭа аԥкуп	Ограниченное время голосования
авеб-наԥҵара анапхгаҩы	директор по развитию продуктов
Иарбоу ацыԥхала анҵамҭа ыҟоуп.	Запись с указанным ключом уже существует.
Аилак анаԥхгара аҭара аԥшьы азин аиура	Разрешить приложению доступ к управлению сообществом
Адунеитә аҳәса рымш	Международный женский день
Аӡәгьы даҳзымԥшааит	Ни одного друга не найдено
Ахархәаҩ даанкылан.	Пользователь заблокирован.
Ахархәаҩ иаанкылара	Заблокировать пользователя
Еиҳа аԥшьқәа арбара	Показать больше приложений
Ҩызакгьы дшәымаӡам.	У вас нет ни одного друга.
Иашәырба ажәла, иарбоу шәдаҟьаҿы	Введите фамилию, указанную на вашей странице
Далышәх аиҿкааҩ.	Выберите организатора.
Аграффити шьҭӡам	Граффити не отправлено
адақьа аанкылоуп	страница заблокирована
Адақьа аанкылоуп	Страница заблокирована
Адаҟьа аанкылара	Заблокировать страницу
Адокумент адҵара	Прикрепление документа
Алԥшаага аԥсахра	Редактировать подборку
Амузыка ԥымкрада	Музыка без ограничений
Аԥшранҵа аиагара	Переместить фотографию
Аԥшранҵа алхӡам.	Фотография не выбрана.
Ахархәаҩ дыԥшаам	Пользователь не найден
Иашәырба абызшәа	Введите название языка
Ишьҭу ацҳамҭақәа	Отправленные сообщения
Шәыбжьылда аномер, шәдаҟьа зыдҳәалоу.	Номер телефона, к которому привязана Ваша страница.
Аԥшьа агәыԥахь ацҵоуп	Приложение добавлено в группу
Еиду Араԥтә Емиратқәа	Объединенные Арабские Эмираты
Ааглыхратә аарыхра	Промышленное производство
Иаанышәкыл сжәытә даҟьа	Заблокируйте мою старую страницу
Шәдаҟьа ашәарҭадара шәазхәыц	Подумайте о безопасности своей страницы
Аиҭагаҩ иҭыӡҭыԥ	Ссылка на переводчика
Анаҩстәи асахьа	Следующее изображение
Аԥшранҵа ацҵара	Добавление фотографии
Аԥшранҵра аркра	Прикрепить фотографии
Аԥшьқәа раԥҵара	Разработка приложений
Ардырра арцәара	Выключить уведомления
Ахаан аламҳәара	Никогда не уведомлять
Ахархәаҩ идаҟьа	Страница пользователя
Ихҩоу абжьыҭира	Анонимное голосование
Смузыка рыцҵара	Добавить в мою музыку
Аԥшәма идаҟьа ықәихит.	Страница удалена её владельцем.
Абжьагаратә аԥшьы	Рекомендуемые приложения
Авеб-камера ԥшаам	Веб-камера не обнаружена
Алаҳәаракгьы ыҟам	Нет ни одного оповещения
Аудионҵамҭа аркра	Прикрепление аудиозаписи
Ҳшәыҳәоит, ҳашәзасаанӡа шәыԥшы.	Пожалуйста, подождите звонка на Ваш телефон.
Амцхә идууп асахьа.	Слишком большая фотография.
Иашәырба аԥшьы ахьӡ	Введите название приложения
Шәдаҟьа ашәарҭадара	Безопасность вашей страницы
Шьҭахьлантәи арбара	Показать в обратном порядке
Аԥшьқәа реизга ацҵара	Добавление подборки приложений
Ааԥхьара аиура	Получить приглашение
Ажәеиларккақәа	Комментарии к отчёту
Аилакра аҿыхра	Отключить сообщество
Аҭоурых анҵара	Опубликовать историю
Ацыԥха аԥсахра	Редактирование ключа
Иалышәх асахьа	Выберите изображение

